Stunden,Wolbecker Straße (gesamt),FR stadteinwärts,FR stadtauswärts,Temperatur (°C),Windstärke (km/h),Wetter
01/01/2016 00:00,89,30,59,3,9,Klarer Himmel
01/01/2016 01:00,164,73,91,3,7,Klarer Himmel
01/01/2016 02:00,188,101,87,3,9,Klarer Himmel
01/01/2016 03:00,186,103,83,3,9,teilweise bewölkt
01/01/2016 04:00,141,82,59,2,6,wolkig
01/01/2016 05:00,66,37,29,3,6,Regen
01/01/2016 06:00,54,32,22,3,7,
01/01/2016 07:00,47,25,22,2,4,
01/01/2016 08:00,27,17,10,0,2,Nebel
01/01/2016 09:00,30,18,12,1,4,wolkig
01/01/2016 10:00,63,26,37,4,6,Nebel
01/01/2016 11:00,58,28,30,5,6,wolkig
01/01/2016 12:00,145,62,83,6,4,wolkig
01/01/2016 13:00,153,97,56,7,4,wolkig
01/01/2016 14:00,158,106,52,7,4,wolkig
01/01/2016 15:00,174,98,76,6,4,Nebel
01/01/2016 16:00,156,74,82,6,6,Nebel
01/01/2016 17:00,141,69,72,5,4,Nebel
01/01/2016 18:00,118,58,60,4,4,Nebel
01/01/2016 19:00,104,52,52,5,7,
01/01/2016 20:00,65,37,28,4,9,wolkig
01/01/2016 21:00,47,25,22,4,9,wolkig
01/01/2016 22:00,70,38,32,4,9,Klarer Himmel
01/01/2016 23:00,27,12,15,4,7,Klarer Himmel
02/01/2016 00:00,27,14,13,4,9,teilweise bewölkt
02/01/2016 01:00,23,15,8,5,9,wolkig
02/01/2016 02:00,10,6,4,4,11,Klarer Himmel
02/01/2016 03:00,5,4,1,4,13,Klarer Himmel
02/01/2016 04:00,1,1,0,4,13,Klarer Himmel
02/01/2016 05:00,22,13,9,4,17,Klarer Himmel
02/01/2016 06:00,34,21,13,4,17,Klarer Himmel
02/01/2016 07:00,57,31,26,4,13,Klarer Himmel
02/01/2016 08:00,80,49,31,4,15,Klarer Himmel
02/01/2016 09:00,244,179,65,4,15,wolkig
02/01/2016 10:00,308,200,108,4,15,Regen
02/01/2016 11:00,334,202,132,3,15,wolkig
02/01/2016 12:00,372,198,174,3,15,Regen
02/01/2016 13:00,395,205,190,3,15,Regen
02/01/2016 14:00,401,184,217,3,13,wolkig
02/01/2016 15:00,349,142,207,3,13,Regen
02/01/2016 16:00,282,125,157,3,15,Regen
02/01/2016 17:00,273,108,165,3,13,Regen
02/01/2016 18:00,211,92,119,2,17,Regen
02/01/2016 19:00,199,83,116,2,13,Regen
02/01/2016 20:00,170,77,93,2,13,wolkig
02/01/2016 21:00,102,45,57,2,15,wolkig
02/01/2016 22:00,92,51,41,2,13,wolkig
02/01/2016 23:00,91,39,52,2,13,wolkig
03/01/2016 00:00,76,37,39,2,13,wolkig
03/01/2016 01:00,58,36,22,2,11,teilweise bewölkt
03/01/2016 02:00,36,24,12,2,15,wolkig
03/01/2016 03:00,30,17,13,2,11,Regen
03/01/2016 04:00,25,15,10,3,15,wolkig
03/01/2016 05:00,11,8,3,3,15,wolkig
03/01/2016 06:00,16,7,9,2,17,Regen
03/01/2016 07:00,27,16,11,2,13,Regen
03/01/2016 08:00,26,12,14,2,17,Regen
03/01/2016 09:00,56,31,25,2,15,Regen
03/01/2016 10:00,91,41,50,2,15,Regen
03/01/2016 11:00,96,52,44,3,11,Regen
03/01/2016 12:00,118,52,66,3,13,Regen
03/01/2016 13:00,116,57,59,3,11,Regen
03/01/2016 14:00,143,72,71,3,9,Regen
03/01/2016 15:00,167,101,66,3,13,wolkig
03/01/2016 16:00,206,114,92,3,11,wolkig
03/01/2016 17:00,207,107,100,3,13,teilweise bewölkt
03/01/2016 18:00,149,71,78,3,11,teilweise bewölkt
03/01/2016 19:00,172,101,71,2,11,wolkig
03/01/2016 20:00,123,66,57,2,15,wolkig
03/01/2016 21:00,105,55,50,2,15,wolkig
03/01/2016 22:00,96,58,38,2,17,wolkig
03/01/2016 23:00,63,31,32,2,15,wolkig
04/01/2016 00:00,39,15,24,2,15,Regen
04/01/2016 01:00,15,7,8,2,15,Schnee
04/01/2016 02:00,6,3,3,1,13,Schnee
04/01/2016 03:00,5,2,3,1,13,Schnee
04/01/2016 04:00,15,6,9,1,13,Regen
04/01/2016 05:00,63,32,31,1,13,Schnee
04/01/2016 06:00,179,90,89,1,11,Schnee
04/01/2016 07:00,398,247,151,1,13,Schnee
04/01/2016 08:00,431,297,134,1,9,Schnee
04/01/2016 09:00,323,226,97,0,9,Schnee
04/01/2016 10:00,277,160,117,0,9,Schnee
04/01/2016 11:00,237,141,96,0,7,Schnee
04/01/2016 12:00,306,151,155,0,9,Schnee
04/01/2016 13:00,344,193,151,0,7,Schnee
04/01/2016 14:00,376,196,180,0,7,wolkig
04/01/2016 15:00,414,200,214,1,6,Schnee
04/01/2016 16:00,599,263,336,0,7,wolkig
04/01/2016 17:00,630,277,353,-1,9,wolkig
04/01/2016 18:00,567,239,328,-1,11,wolkig
04/01/2016 19:00,413,152,261,-1,9,Regen
04/01/2016 20:00,247,112,135,-1,6,Regen
04/01/2016 21:00,136,69,67,-1,6,Schneeregen
04/01/2016 22:00,108,65,43,0,4,wolkig
04/01/2016 23:00,96,52,44,0,6,Schnee
05/01/2016 00:00,48,32,16,0,4,Schnee
05/01/2016 01:00,17,10,7,1,6,wolkig
05/01/2016 02:00,13,7,6,1,4,wolkig
05/01/2016 03:00,7,2,5,1,4,wolkig
05/01/2016 04:00,15,5,10,1,4,wolkig
05/01/2016 05:00,60,34,26,,,
05/01/2016 06:00,205,106,99,,,
05/01/2016 07:00,437,257,180,,,
05/01/2016 08:00,559,392,167,3,4,wolkig
05/01/2016 09:00,469,328,141,3,7,wolkig
05/01/2016 10:00,433,269,164,4,6,wolkig
05/01/2016 11:00,453,248,205,4,7,wolkig
05/01/2016 12:00,480,263,217,5,7,wolkig
05/01/2016 13:00,505,257,248,5,7,wolkig
05/01/2016 14:00,563,281,282,4,7,wolkig
05/01/2016 15:00,617,297,320,2,11,wolkig
05/01/2016 16:00,693,297,396,1,13,wolkig
05/01/2016 17:00,783,341,442,0,11,wolkig
05/01/2016 18:00,667,287,380,0,9,wolkig
05/01/2016 19:00,499,221,278,-1,13,Schneeregen
05/01/2016 20:00,315,123,192,-1,13,wolkig
05/01/2016 21:00,186,94,92,-1,11,wolkig
05/01/2016 22:00,187,96,91,-2,13,wolkig
05/01/2016 23:00,92,53,39,-2,11,wolkig
06/01/2016 00:00,46,23,23,-2,15,wolkig
06/01/2016 01:00,25,10,15,-2,13,wolkig
06/01/2016 02:00,18,10,8,-2,9,Schneeregen
06/01/2016 03:00,9,6,3,-2,11,wolkig
06/01/2016 04:00,14,8,6,-2,11,wolkig
06/01/2016 05:00,59,27,32,-2,13,wolkig
06/01/2016 06:00,211,109,102,-2,13,Schneeregen
06/01/2016 07:00,472,292,180,-2,11,Schneeregen
06/01/2016 08:00,544,381,163,-2,11,Schneeregen
06/01/2016 09:00,462,327,135,-2,11,Schneeregen
06/01/2016 10:00,440,290,150,-2,11,Schneeregen
06/01/2016 11:00,430,259,171,-2,11,Schneeregen
06/01/2016 12:00,533,274,259,-2,11,Schneeregen
06/01/2016 13:00,525,303,222,-2,11,wolkig
06/01/2016 14:00,521,236,285,-2,15,wolkig
06/01/2016 15:00,530,235,295,-2,9,wolkig
06/01/2016 16:00,659,282,377,-2,9,wolkig
06/01/2016 17:00,734,345,389,-2,7,wolkig
06/01/2016 18:00,696,289,407,-2,9,wolkig
06/01/2016 19:00,492,189,303,-2,6,wolkig
06/01/2016 20:00,342,144,198,-2,7,wolkig
06/01/2016 21:00,225,124,101,-2,7,wolkig
06/01/2016 22:00,207,119,88,-2,6,wolkig
06/01/2016 23:00,105,58,47,-1,6,wolkig
07/01/2016 00:00,55,28,27,-1,6,wolkig
07/01/2016 01:00,20,9,11,-1,6,wolkig
07/01/2016 02:00,20,9,11,0,2,wolkig
07/01/2016 03:00,10,3,7,0,4,wolkig
07/01/2016 04:00,21,9,12,0,6,wolkig
07/01/2016 05:00,61,26,35,1,6,wolkig
07/01/2016 06:00,256,109,147,1,7,wolkig
07/01/2016 07:00,840,584,256,2,11,Nebel
07/01/2016 08:00,707,489,218,2,7,Nebel
07/01/2016 09:00,597,425,172,3,13,Nebel
07/01/2016 10:00,472,287,185,3,9,
07/01/2016 11:00,562,344,218,5,9,
07/01/2016 12:00,527,254,273,5,9,Klarer Himmel
07/01/2016 13:00,640,328,312,6,9,Klarer Himmel
07/01/2016 14:00,643,307,336,6,17,Klarer Himmel
07/01/2016 15:00,729,323,406,6,15,wolkig
07/01/2016 16:00,769,310,459,5,17,Regen
07/01/2016 17:00,703,324,379,5,15,Regen
07/01/2016 18:00,572,226,346,5,24,Regen
07/01/2016 19:00,510,230,280,5,20,Regen
07/01/2016 20:00,271,100,171,5,19,Regen
07/01/2016 21:00,204,88,116,7,43,Regen
07/01/2016 22:00,163,78,85,6,35,Regen
07/01/2016 23:00,108,47,61,6,28,teilweise bewölkt
08/01/2016 00:00,43,25,18,6,30,teilweise bewölkt
08/01/2016 01:00,25,12,13,5,32,teilweise bewölkt
08/01/2016 02:00,4,1,3,5,28,wolkig
08/01/2016 03:00,13,2,11,5,33,Klarer Himmel
08/01/2016 04:00,14,6,8,5,32,Klarer Himmel
08/01/2016 05:00,59,28,31,5,32,Klarer Himmel
08/01/2016 06:00,233,100,133,5,32,Klarer Himmel
08/01/2016 07:00,773,514,259,5,28,teilweise bewölkt
08/01/2016 08:00,679,477,202,4,28,teilweise bewölkt
08/01/2016 09:00,580,404,176,4,26,teilweise bewölkt
08/01/2016 10:00,503,342,161,5,28,teilweise bewölkt
08/01/2016 11:00,553,317,236,6,26,teilweise bewölkt
08/01/2016 12:00,663,330,333,7,24,teilweise bewölkt
08/01/2016 13:00,819,371,448,7,24,teilweise bewölkt
08/01/2016 14:00,809,409,400,8,19,teilweise bewölkt
08/01/2016 15:00,816,356,460,7,17,teilweise bewölkt
08/01/2016 16:00,790,344,446,7,13,wolkig
08/01/2016 17:00,767,350,417,7,15,wolkig
08/01/2016 18:00,662,285,377,6,13,teilweise bewölkt
08/01/2016 19:00,576,275,301,5,9,Klarer Himmel
08/01/2016 20:00,378,163,215,4,11,Klarer Himmel
08/01/2016 21:00,283,131,152,4,11,Klarer Himmel
08/01/2016 22:00,263,123,140,2,7,Klarer Himmel
08/01/2016 23:00,217,97,120,2,7,Klarer Himmel
09/01/2016 00:00,186,86,100,1,6,Klarer Himmel
09/01/2016 01:00,156,60,96,1,6,Klarer Himmel
09/01/2016 02:00,97,43,54,0,6,Klarer Himmel
09/01/2016 03:00,48,20,28,1,7,wolkig
09/01/2016 04:00,44,22,22,1,9,wolkig
09/01/2016 05:00,48,29,19,1,7,Schnee
09/01/2016 06:00,43,25,18,1,9,wolkig
09/01/2016 07:00,110,61,49,1,9,teilweise bewölkt
09/01/2016 08:00,197,113,84,1,9,teilweise bewölkt
09/01/2016 09:00,374,261,113,2,9,Klarer Himmel
09/01/2016 10:00,524,357,167,4,9,Klarer Himmel
09/01/2016 11:00,644,396,248,6,13,Klarer Himmel
09/01/2016 12:00,715,418,297,6,7,Klarer Himmel
09/01/2016 13:00,744,398,346,7,11,Klarer Himmel
09/01/2016 14:00,736,318,418,7,9,Klarer Himmel
09/01/2016 15:00,679,303,376,7,7,Klarer Himmel
09/01/2016 16:00,550,204,346,7,9,Klarer Himmel
09/01/2016 17:00,522,222,300,7,9,Klarer Himmel
09/01/2016 18:00,490,194,296,6,13,Klarer Himmel
09/01/2016 19:00,426,194,232,5,20,Klarer Himmel
09/01/2016 20:00,318,168,150,5,15,wolkig
09/01/2016 21:00,215,106,109,4,13,teilweise bewölkt
09/01/2016 22:00,218,123,95,3,13,teilweise bewölkt
09/01/2016 23:00,168,67,101,3,13,teilweise bewölkt
10/01/2016 00:00,199,84,115,2,9,Klarer Himmel
10/01/2016 01:00,146,66,80,3,15,teilweise bewölkt
10/01/2016 02:00,97,54,43,3,15,Klarer Himmel
10/01/2016 03:00,66,35,31,4,13,wolkig
10/01/2016 04:00,49,26,23,4,13,Regen
10/01/2016 05:00,35,24,11,5,13,wolkig
10/01/2016 06:00,33,15,18,5,13,wolkig
10/01/2016 07:00,40,15,25,6,9,Regen
10/01/2016 08:00,62,36,26,6,13,Regen
10/01/2016 09:00,114,72,42,6,15,wolkig
10/01/2016 10:00,207,119,88,7,19,wolkig
10/01/2016 11:00,218,126,92,8,22,teilweise bewölkt
10/01/2016 12:00,245,125,120,8,20,teilweise bewölkt
10/01/2016 13:00,349,196,153,9,22,teilweise bewölkt
10/01/2016 14:00,425,253,172,9,19,teilweise bewölkt
10/01/2016 15:00,372,186,186,8,17,teilweise bewölkt
10/01/2016 16:00,424,203,221,7,11,Klarer Himmel
10/01/2016 17:00,331,163,168,7,15,Klarer Himmel
10/01/2016 18:00,357,182,175,7,11,wolkig
10/01/2016 19:00,267,164,103,6,11,Regen
10/01/2016 20:00,175,93,82,5,6,wolkig
10/01/2016 21:00,118,64,54,5,7,wolkig
10/01/2016 22:00,117,73,44,5,9,wolkig
10/01/2016 23:00,44,18,26,5,13,wolkig
11/01/2016 00:00,27,17,10,5,9,wolkig
11/01/2016 01:00,7,3,4,5,11,wolkig
11/01/2016 02:00,4,1,3,6,9,wolkig
11/01/2016 03:00,3,0,3,6,11,wolkig
11/01/2016 04:00,10,4,6,4,6,wolkig
11/01/2016 05:00,75,32,43,3,9,teilweise bewölkt
11/01/2016 06:00,261,113,148,3,7,teilweise bewölkt
11/01/2016 07:00,896,593,303,3,7,teilweise bewölkt
11/01/2016 08:00,806,575,231,3,7,Klarer Himmel
11/01/2016 09:00,683,530,153,3,9,Klarer Himmel
11/01/2016 10:00,512,322,190,3,9,Klarer Himmel
11/01/2016 11:00,523,305,218,4,7,wolkig
11/01/2016 12:00,595,273,322,5,9,Regen
11/01/2016 13:00,548,274,274,5,13,Regen
11/01/2016 14:00,483,222,261,5,7,Regen
11/01/2016 15:00,610,270,340,5,9,Regen
11/01/2016 16:00,771,316,455,5,7,Regen
11/01/2016 17:00,849,370,479,5,9,wolkig
11/01/2016 18:00,774,302,472,5,6,wolkig
11/01/2016 19:00,578,222,356,5,7,Regen
11/01/2016 20:00,316,124,192,5,7,wolkig
11/01/2016 21:00,258,120,138,6,13,wolkig
11/01/2016 22:00,179,85,94,6,13,Regen
11/01/2016 23:00,94,50,44,6,11,Regen
12/01/2016 00:00,40,16,24,6,17,Regen
12/01/2016 01:00,22,14,8,6,17,Regen
12/01/2016 02:00,9,2,7,6,13,Regen
12/01/2016 03:00,6,4,2,6,15,wolkig
12/01/2016 04:00,13,9,4,6,15,wolkig
12/01/2016 05:00,69,27,42,5,20,wolkig
12/01/2016 06:00,282,127,155,5,20,wolkig
12/01/2016 07:00,905,604,301,6,22,wolkig
12/01/2016 08:00,796,573,223,5,19,wolkig
12/01/2016 09:00,684,501,183,6,20,wolkig
12/01/2016 10:00,500,331,169,6,19,wolkig
12/01/2016 11:00,514,299,215,6,26,wolkig
12/01/2016 12:00,554,281,273,6,22,Regen
12/01/2016 13:00,648,303,345,7,22,wolkig
12/01/2016 14:00,617,277,340,6,20,Regen
12/01/2016 15:00,733,344,389,6,20,wolkig
12/01/2016 16:00,889,372,517,7,17,wolkig
12/01/2016 17:00,956,447,509,7,17,wolkig
12/01/2016 18:00,883,368,515,6,17,wolkig
12/01/2016 19:00,748,351,397,6,17,wolkig
12/01/2016 20:00,419,162,257,6,20,wolkig
12/01/2016 21:00,285,110,175,6,24,wolkig
12/01/2016 22:00,288,144,144,5,22,wolkig
12/01/2016 23:00,150,73,77,5,20,Regen
13/01/2016 00:00,57,32,25,4,20,Regen
13/01/2016 01:00,27,14,13,4,15,wolkig
13/01/2016 02:00,6,3,3,4,17,Regen
13/01/2016 03:00,4,2,2,4,17,Regen
13/01/2016 04:00,12,5,7,5,19,wolkig
13/01/2016 05:00,66,26,40,5,20,wolkig
13/01/2016 06:00,290,117,173,5,22,wolkig
13/01/2016 07:00,856,570,286,5,24,Regen
13/01/2016 08:00,830,584,246,5,24,wolkig
13/01/2016 09:00,682,505,177,5,17,wolkig
13/01/2016 10:00,558,357,201,5,19,wolkig
13/01/2016 11:00,527,293,234,6,17,wolkig
13/01/2016 12:00,632,307,325,6,17,wolkig
13/01/2016 13:00,755,358,397,6,13,wolkig
13/01/2016 14:00,662,307,355,6,19,wolkig
13/01/2016 15:00,720,327,393,6,7,wolkig
13/01/2016 16:00,789,309,480,5,28,Regen
13/01/2016 17:00,860,402,458,4,15,wolkig
13/01/2016 18:00,744,318,426,4,13,wolkig
13/01/2016 19:00,630,266,364,5,20,wolkig
13/01/2016 20:00,396,168,228,4,20,teilweise bewölkt
13/01/2016 21:00,302,128,174,3,17,teilweise bewölkt
13/01/2016 22:00,258,128,130,3,11,teilweise bewölkt
13/01/2016 23:00,154,87,67,3,11,teilweise bewölkt
14/01/2016 00:00,83,30,53,3,15,teilweise bewölkt
14/01/2016 01:00,44,24,20,2,13,teilweise bewölkt
14/01/2016 02:00,23,8,15,1,9,teilweise bewölkt
14/01/2016 03:00,7,1,6,1,9,wolkig
14/01/2016 04:00,18,9,9,1,9,teilweise bewölkt
14/01/2016 05:00,61,25,36,1,13,wolkig
14/01/2016 06:00,244,104,140,1,13,wolkig
14/01/2016 07:00,851,575,276,1,13,wolkig
14/01/2016 08:00,792,550,242,2,17,Klarer Himmel
14/01/2016 09:00,652,479,173,2,19,Klarer Himmel
14/01/2016 10:00,479,306,173,4,22,wolkig
14/01/2016 11:00,530,287,243,4,22,Regen
14/01/2016 12:00,503,258,245,4,28,Regen
14/01/2016 13:00,541,248,293,4,20,Regen
14/01/2016 14:00,539,258,281,3,22,Regen
14/01/2016 15:00,592,261,331,2,19,Regen
14/01/2016 16:00,766,327,439,3,15,wolkig
14/01/2016 17:00,838,384,454,3,15,wolkig
14/01/2016 18:00,846,354,492,3,15,teilweise bewölkt
14/01/2016 19:00,586,242,344,3,17,Regen
14/01/2016 20:00,387,148,239,2,17,wolkig
14/01/2016 21:00,252,112,140,3,17,Regen
14/01/2016 22:00,231,109,122,3,17,Regen
14/01/2016 23:00,140,69,71,3,15,Regen
15/01/2016 00:00,75,36,39,3,15,wolkig
15/01/2016 01:00,28,12,16,3,15,Regen
15/01/2016 02:00,15,11,4,2,15,Regen
15/01/2016 03:00,17,6,11,2,15,Schnee
15/01/2016 04:00,14,8,6,2,13,Schnee
15/01/2016 05:00,58,21,37,1,7,Schnee
15/01/2016 06:00,222,94,128,2,6,Schnee
15/01/2016 07:00,757,506,251,2,7,wolkig
15/01/2016 08:00,704,487,217,1,13,wolkig
15/01/2016 09:00,552,397,155,2,9,wolkig
15/01/2016 10:00,484,323,161,2,9,wolkig
15/01/2016 11:00,521,280,241,3,11,wolkig
15/01/2016 12:00,626,299,327,3,17,wolkig
15/01/2016 13:00,764,319,445,2,13,wolkig
15/01/2016 14:00,718,336,382,3,13,wolkig
15/01/2016 15:00,681,318,363,2,20,wolkig
15/01/2016 16:00,708,300,408,2,15,wolkig
15/01/2016 17:00,697,301,396,2,9,wolkig
15/01/2016 18:00,628,258,370,2,11,wolkig
15/01/2016 19:00,557,245,312,2,9,wolkig
15/01/2016 20:00,357,158,199,1,9,wolkig
15/01/2016 21:00,260,124,136,2,9,wolkig
15/01/2016 22:00,246,129,117,2,7,wolkig
15/01/2016 23:00,177,82,95,0,4,wolkig
16/01/2016 00:00,167,76,91,0,4,wolkig
16/01/2016 01:00,147,52,95,0,7,wolkig
16/01/2016 02:00,88,48,40,1,7,wolkig
16/01/2016 03:00,67,30,37,1,9,teilweise bewölkt
16/01/2016 04:00,58,39,19,1,9,teilweise bewölkt
16/01/2016 05:00,43,23,20,0,9,teilweise bewölkt
16/01/2016 06:00,52,25,27,0,13,wolkig
16/01/2016 07:00,103,58,45,1,20,Schnee
16/01/2016 08:00,196,111,85,1,20,Schnee
16/01/2016 09:00,340,233,107,2,22,Schnee
16/01/2016 10:00,367,244,123,2,20,Regen
16/01/2016 11:00,417,249,168,2,32,Regen
16/01/2016 12:00,392,199,193,1,26,Schnee
16/01/2016 13:00,425,232,193,1,30,wolkig
16/01/2016 14:00,473,217,256,2,24,wolkig
16/01/2016 15:00,434,199,235,1,17,Schnee
16/01/2016 16:00,452,179,273,1,13,Schnee
16/01/2016 17:00,361,140,221,1,11,teilweise bewölkt
16/01/2016 18:00,410,170,240,0,9,wolkig
16/01/2016 19:00,329,146,183,0,17,Schnee
16/01/2016 20:00,264,114,150,0,9,teilweise bewölkt
16/01/2016 21:00,202,95,107,-1,11,teilweise bewölkt
16/01/2016 22:00,198,108,90,0,17,Schnee
16/01/2016 23:00,152,85,67,0,17,teilweise bewölkt
17/01/2016 00:00,151,81,70,0,17,wolkig
17/01/2016 01:00,125,72,53,-1,13,wolkig
17/01/2016 02:00,87,41,46,-1,13,Klarer Himmel
17/01/2016 03:00,52,34,18,-1,17,wolkig
17/01/2016 04:00,57,42,15,0,13,wolkig
17/01/2016 05:00,32,18,14,-1,19,wolkig
17/01/2016 06:00,26,15,11,-1,15,wolkig
17/01/2016 07:00,44,22,22,-1,13,wolkig
17/01/2016 08:00,52,24,28,-1,13,wolkig
17/01/2016 09:00,99,62,37,-1,9,wolkig
17/01/2016 10:00,167,98,69,0,7,wolkig
17/01/2016 11:00,194,115,79,0,11,wolkig
17/01/2016 12:00,233,131,102,0,11,wolkig
17/01/2016 13:00,242,131,111,0,11,wolkig
17/01/2016 14:00,240,123,117,0,9,Schnee
17/01/2016 15:00,263,131,132,0,11,wolkig
17/01/2016 16:00,278,146,132,-1,9,teilweise bewölkt
17/01/2016 17:00,258,132,126,-2,2,teilweise bewölkt
17/01/2016 18:00,290,147,143,-3,2,Klarer Himmel
17/01/2016 19:00,273,124,149,-4,4,Klarer Himmel
17/01/2016 20:00,181,97,84,-5,2,Klarer Himmel
17/01/2016 21:00,121,69,52,-5,4,Nebel
17/01/2016 22:00,136,89,47,-6,2,Nebel
17/01/2016 23:00,71,39,32,-7,2,Klarer Himmel
18/01/2016 00:00,47,32,15,-6,2,Nebel
18/01/2016 01:00,9,3,6,-7,0,Klarer Himmel
18/01/2016 02:00,4,1,3,-7,0,Klarer Himmel
18/01/2016 03:00,2,1,1,-7,2,
18/01/2016 04:00,10,6,4,-7,6,Klarer Himmel
18/01/2016 05:00,66,32,34,-7,2,
18/01/2016 06:00,237,105,132,-7,2,
18/01/2016 07:00,727,470,257,-7,4,
18/01/2016 08:00,706,501,205,-6,6,Nebel
18/01/2016 09:00,583,435,148,-5,6,Nebel
18/01/2016 10:00,480,331,149,-4,6,
18/01/2016 11:00,468,279,189,-3,6,
18/01/2016 12:00,516,272,244,-2,7,Klarer Himmel
18/01/2016 13:00,631,320,311,-1,7,teilweise bewölkt
18/01/2016 14:00,594,294,300,-1,9,teilweise bewölkt
18/01/2016 15:00,676,321,355,-1,6,Klarer Himmel
18/01/2016 16:00,810,365,445,-2,6,Klarer Himmel
18/01/2016 17:00,884,361,523,-3,6,Klarer Himmel
18/01/2016 18:00,762,301,461,-3,4,Klarer Himmel
18/01/2016 19:00,602,258,344,-3,4,Klarer Himmel
18/01/2016 20:00,334,135,199,-4,7,Klarer Himmel
18/01/2016 21:00,241,90,151,-4,9,Klarer Himmel
18/01/2016 22:00,209,101,108,-5,6,Klarer Himmel
18/01/2016 23:00,110,55,55,-5,4,Klarer Himmel
19/01/2016 00:00,49,27,22,-5,6,Klarer Himmel
19/01/2016 01:00,20,10,10,-6,9,Klarer Himmel
19/01/2016 02:00,5,2,3,-7,4,Klarer Himmel
19/01/2016 03:00,4,1,3,-8,2,Klarer Himmel
19/01/2016 04:00,16,6,10,-8,2,Klarer Himmel
19/01/2016 05:00,69,31,38,-7,4,Klarer Himmel
19/01/2016 06:00,240,106,134,-8,4,Klarer Himmel
19/01/2016 07:00,819,544,275,-8,7,Klarer Himmel
19/01/2016 08:00,747,524,223,-8,6,Klarer Himmel
19/01/2016 09:00,618,444,174,-7,6,Klarer Himmel
19/01/2016 10:00,476,306,170,-4,6,Klarer Himmel
19/01/2016 11:00,459,288,171,-3,13,Klarer Himmel
19/01/2016 12:00,555,274,281,-2,13,Klarer Himmel
19/01/2016 13:00,646,299,347,-1,13,Klarer Himmel
19/01/2016 14:00,590,290,300,-1,11,Klarer Himmel
19/01/2016 15:00,686,339,347,-1,11,
19/01/2016 16:00,844,380,464,-1,11,wolkig
19/01/2016 17:00,883,392,491,-1,9,wolkig
19/01/2016 18:00,824,344,480,-2,17,Schnee
19/01/2016 19:00,643,262,381,-2,9,Schnee
19/01/2016 20:00,378,165,213,-2,15,Schnee
19/01/2016 21:00,277,116,161,-1,11,wolkig
19/01/2016 22:00,250,137,113,-1,9,wolkig
19/01/2016 23:00,109,54,55,-1,13,Klarer Himmel
20/01/2016 00:00,53,29,24,-1,9,wolkig
20/01/2016 01:00,19,7,12,-1,9,wolkig
20/01/2016 02:00,9,5,4,-1,9,wolkig
20/01/2016 03:00,5,1,4,-1,9,Schnee
20/01/2016 04:00,15,7,8,-1,13,wolkig
20/01/2016 05:00,70,33,37,-1,13,wolkig
20/01/2016 06:00,257,119,138,0,13,wolkig
20/01/2016 07:00,790,506,284,-1,13,Schnee
20/01/2016 08:00,765,533,232,0,15,wolkig
20/01/2016 09:00,561,410,151,0,17,wolkig
20/01/2016 10:00,444,279,165,1,17,wolkig
20/01/2016 11:00,464,288,176,1,15,Schnee
20/01/2016 12:00,545,273,272,2,19,wolkig
20/01/2016 13:00,593,297,296,3,15,wolkig
20/01/2016 14:00,618,276,342,2,15,wolkig
20/01/2016 15:00,622,280,342,2,11,wolkig
20/01/2016 16:00,782,325,457,2,11,wolkig
20/01/2016 17:00,790,371,419,1,9,wolkig
20/01/2016 18:00,738,308,430,1,6,wolkig
20/01/2016 19:00,642,296,346,1,6,wolkig
20/01/2016 20:00,402,166,236,1,4,wolkig
20/01/2016 21:00,293,140,153,1,4,wolkig
20/01/2016 22:00,267,118,149,1,4,wolkig
20/01/2016 23:00,158,70,88,1,4,wolkig
21/01/2016 00:00,77,32,45,0,4,wolkig
21/01/2016 01:00,47,13,34,-2,2,teilweise bewölkt
21/01/2016 02:00,19,6,13,-3,4,Nebel
21/01/2016 03:00,16,6,10,-4,2,Nebel
21/01/2016 04:00,17,5,12,-5,4,Nebel
21/01/2016 05:00,62,33,29,-4,4,Nebel
21/01/2016 06:00,238,100,138,-4,2,Nebel
21/01/2016 07:00,742,479,263,-3,4,wolkig
21/01/2016 08:00,739,532,207,-3,2,Nebel
21/01/2016 09:00,584,412,172,-3,4,wolkig
21/01/2016 10:00,476,331,145,-2,4,teilweise bewölkt
21/01/2016 11:00,517,302,215,-2,6,Nebel
21/01/2016 12:00,558,253,305,-3,7,Nebel
21/01/2016 13:00,579,276,303,-3,7,Nebel
21/01/2016 14:00,601,276,325,-3,6,Nebel
21/01/2016 15:00,689,334,355,-3,6,Nebel
21/01/2016 16:00,738,302,436,-2,4,Nebel
21/01/2016 17:00,830,361,469,-2,7,Nebel
21/01/2016 18:00,739,307,432,-3,6,Nebel
21/01/2016 19:00,640,288,352,-3,6,Nebel
21/01/2016 20:00,383,156,227,-4,6,Nebel
21/01/2016 21:00,273,128,145,-5,4,wolkig
21/01/2016 22:00,202,87,115,-5,4,Nebel
21/01/2016 23:00,149,70,79,-6,2,
22/01/2016 00:00,76,38,38,-6,6,
22/01/2016 01:00,41,18,23,-6,6,
22/01/2016 02:00,16,6,10,-6,6,
22/01/2016 03:00,6,2,4,-6,6,
22/01/2016 04:00,19,12,7,-6,6,
22/01/2016 05:00,66,36,30,-6,7,
22/01/2016 06:00,228,97,131,-6,7,
22/01/2016 07:00,715,483,232,-6,7,
22/01/2016 08:00,661,436,225,-6,9,
22/01/2016 09:00,550,403,147,-5,9,
22/01/2016 10:00,459,304,155,-3,9,
22/01/2016 11:00,506,298,208,-2,11,
22/01/2016 12:00,637,301,336,-1,15,Klarer Himmel
22/01/2016 13:00,762,348,414,0,15,Klarer Himmel
22/01/2016 14:00,712,317,395,1,13,Klarer Himmel
22/01/2016 15:00,743,332,411,1,11,Klarer Himmel
22/01/2016 16:00,731,302,429,0,9,Klarer Himmel
22/01/2016 17:00,682,289,393,0,13,Klarer Himmel
22/01/2016 18:00,587,235,352,0,13,Klarer Himmel
22/01/2016 19:00,527,249,278,1,13,Klarer Himmel
22/01/2016 20:00,352,167,185,0,11,Klarer Himmel
22/01/2016 21:00,216,101,115,0,9,Regen
22/01/2016 22:00,205,110,95,0,11,Regen
22/01/2016 23:00,157,74,83,0,9,Regen
23/01/2016 00:00,120,56,64,1,9,Regen
23/01/2016 01:00,106,43,63,2,9,Regen
23/01/2016 02:00,57,23,34,3,11,Regen
23/01/2016 03:00,40,15,25,3,20,wolkig
23/01/2016 04:00,19,13,6,4,19,Regen
23/01/2016 05:00,43,24,19,4,17,wolkig
23/01/2016 06:00,50,24,26,5,9,wolkig
23/01/2016 07:00,73,45,28,5,13,wolkig
23/01/2016 08:00,174,98,76,5,15,wolkig
23/01/2016 09:00,371,250,121,6,22,wolkig
23/01/2016 10:00,462,318,144,6,15,wolkig
23/01/2016 11:00,526,321,205,6,15,wolkig
23/01/2016 12:00,563,316,247,7,17,wolkig
23/01/2016 13:00,613,314,299,7,24,wolkig
23/01/2016 14:00,589,258,331,6,17,wolkig
23/01/2016 15:00,506,207,299,6,17,wolkig
23/01/2016 16:00,447,180,267,6,11,wolkig
23/01/2016 17:00,480,182,298,6,13,Regen
23/01/2016 18:00,401,169,232,6,13,Regen
23/01/2016 19:00,382,153,229,6,13,wolkig
23/01/2016 20:00,315,144,171,6,11,wolkig
23/01/2016 21:00,224,121,103,6,9,wolkig
23/01/2016 22:00,173,106,67,6,11,wolkig
23/01/2016 23:00,160,74,86,6,9,wolkig
24/01/2016 00:00,181,93,88,5,7,wolkig
24/01/2016 01:00,168,73,95,5,9,wolkig
24/01/2016 02:00,101,52,49,5,6,
24/01/2016 03:00,72,36,36,4,6,Klarer Himmel
24/01/2016 04:00,67,41,26,4,7,Klarer Himmel
24/01/2016 05:00,26,22,4,5,9,Klarer Himmel
24/01/2016 06:00,31,18,13,4,9,Klarer Himmel
24/01/2016 07:00,34,14,20,4,7,wolkig
24/01/2016 08:00,55,28,27,4,7,Klarer Himmel
24/01/2016 09:00,150,89,61,4,11,Regen
24/01/2016 10:00,194,119,75,6,13,wolkig
24/01/2016 11:00,194,88,106,6,13,wolkig
24/01/2016 12:00,211,117,94,7,15,wolkig
24/01/2016 13:00,222,104,118,6,13,wolkig
24/01/2016 14:00,288,137,151,7,15,Regen
24/01/2016 15:00,244,138,106,7,13,Regen
24/01/2016 16:00,283,149,134,7,11,Regen
24/01/2016 17:00,262,135,127,7,7,Regen
24/01/2016 18:00,292,154,138,7,9,Regen
24/01/2016 19:00,244,143,101,7,9,Regen
24/01/2016 20:00,178,86,92,8,11,Regen
24/01/2016 21:00,112,74,38,8,13,wolkig
24/01/2016 22:00,123,73,50,9,17,wolkig
24/01/2016 23:00,67,36,31,9,15,wolkig
25/01/2016 00:00,26,19,7,9,15,wolkig
25/01/2016 01:00,17,11,6,9,15,wolkig
25/01/2016 02:00,6,3,3,9,15,wolkig
25/01/2016 03:00,5,3,2,9,15,wolkig
25/01/2016 04:00,16,8,8,9,15,wolkig
25/01/2016 05:00,75,41,34,9,11,wolkig
25/01/2016 06:00,295,142,153,9,11,wolkig
25/01/2016 07:00,790,508,282,9,6,wolkig
25/01/2016 08:00,805,569,236,9,4,wolkig
25/01/2016 09:00,662,497,165,10,6,wolkig
25/01/2016 10:00,517,336,181,10,9,wolkig
25/01/2016 11:00,534,315,219,12,13,wolkig
25/01/2016 12:00,612,314,298,13,15,wolkig
25/01/2016 13:00,682,376,306,13,19,wolkig
25/01/2016 14:00,671,342,329,13,17,wolkig
25/01/2016 15:00,785,392,393,13,17,Klarer Himmel
25/01/2016 16:00,886,384,502,12,13,Klarer Himmel
25/01/2016 17:00,998,428,570,11,13,Klarer Himmel
25/01/2016 18:00,872,332,540,10,11,Klarer Himmel
25/01/2016 19:00,631,271,360,8,9,Klarer Himmel
25/01/2016 20:00,415,177,238,9,9,Klarer Himmel
25/01/2016 21:00,283,119,164,11,15,Klarer Himmel
25/01/2016 22:00,240,106,134,11,24,wolkig
25/01/2016 23:00,94,41,53,11,17,wolkig
26/01/2016 00:00,52,23,29,11,17,wolkig
26/01/2016 01:00,28,12,16,11,20,wolkig
26/01/2016 02:00,10,8,2,11,20,wolkig
26/01/2016 03:00,12,4,8,10,20,wolkig
26/01/2016 04:00,15,9,6,10,20,wolkig
26/01/2016 05:00,78,40,38,10,20,wolkig
26/01/2016 06:00,311,154,157,9,17,wolkig
26/01/2016 07:00,943,627,316,9,13,teilweise bewölkt
26/01/2016 08:00,776,560,216,9,11,Klarer Himmel
26/01/2016 09:00,727,544,183,9,7,wolkig
26/01/2016 10:00,543,342,201,10,15,wolkig
26/01/2016 11:00,593,349,244,10,20,wolkig
26/01/2016 12:00,680,298,382,11,19,wolkig
26/01/2016 13:00,651,298,353,10,17,Regen
26/01/2016 14:00,595,273,322,11,19,wolkig
26/01/2016 15:00,689,326,363,11,26,wolkig
26/01/2016 16:00,922,419,503,11,26,wolkig
26/01/2016 17:00,916,407,509,11,22,wolkig
26/01/2016 18:00,914,374,540,10,28,Klarer Himmel
26/01/2016 19:00,777,359,418,10,30,wolkig
26/01/2016 20:00,390,152,238,9,30,Regen
26/01/2016 21:00,322,137,185,9,28,Regen
26/01/2016 22:00,287,160,127,9,32,Regen
26/01/2016 23:00,114,51,63,9,33,Regen
27/01/2016 00:00,50,24,26,9,32,Regen
27/01/2016 01:00,26,14,12,9,28,wolkig
27/01/2016 02:00,11,4,7,10,24,wolkig
27/01/2016 03:00,8,3,5,10,28,wolkig
27/01/2016 04:00,8,4,4,10,30,wolkig
27/01/2016 05:00,68,35,33,10,32,wolkig
27/01/2016 06:00,302,141,161,11,33,wolkig
27/01/2016 07:00,838,560,278,11,30,wolkig
27/01/2016 08:00,860,611,249,11,30,wolkig
27/01/2016 09:00,641,466,175,11,28,wolkig
27/01/2016 10:00,466,277,189,10,32,Regen
27/01/2016 11:00,402,217,185,10,26,Regen
27/01/2016 12:00,500,252,248,10,30,wolkig
27/01/2016 13:00,591,292,299,11,28,wolkig
27/01/2016 14:00,623,299,324,11,28,wolkig
27/01/2016 15:00,665,290,375,12,26,wolkig
27/01/2016 16:00,792,338,454,12,26,wolkig
27/01/2016 17:00,872,382,490,12,32,wolkig
27/01/2016 18:00,774,331,443,12,28,wolkig
27/01/2016 19:00,661,299,362,11,26,wolkig
27/01/2016 20:00,408,172,236,10,24,Regen
27/01/2016 21:00,268,115,153,10,28,Regen
27/01/2016 22:00,286,144,142,10,28,Regen
27/01/2016 23:00,140,81,59,10,26,Regen
28/01/2016 00:00,65,30,35,10,26,Regen
28/01/2016 01:00,47,19,28,10,26,Regen
28/01/2016 02:00,14,2,12,8,24,Regen
28/01/2016 03:00,14,5,9,8,22,Regen
28/01/2016 04:00,15,6,9,7,19,wolkig
28/01/2016 05:00,62,36,26,7,22,wolkig
28/01/2016 06:00,269,128,141,7,20,wolkig
28/01/2016 07:00,820,543,277,6,19,teilweise bewölkt
28/01/2016 08:00,776,561,215,5,17,teilweise bewölkt
28/01/2016 09:00,650,473,177,6,19,teilweise bewölkt
28/01/2016 10:00,525,340,185,7,28,teilweise bewölkt
28/01/2016 11:00,594,334,260,7,30,teilweise bewölkt
28/01/2016 12:00,535,267,268,8,24,teilweise bewölkt
28/01/2016 13:00,693,343,350,8,26,teilweise bewölkt
28/01/2016 14:00,679,328,351,8,22,teilweise bewölkt
28/01/2016 15:00,817,404,413,8,20,teilweise bewölkt
28/01/2016 16:00,938,407,531,7,17,teilweise bewölkt
28/01/2016 17:00,970,427,543,6,13,Klarer Himmel
28/01/2016 18:00,864,365,499,5,11,Klarer Himmel
28/01/2016 19:00,636,279,357,5,13,Klarer Himmel
28/01/2016 20:00,421,165,256,5,15,Klarer Himmel
28/01/2016 21:00,305,131,174,4,13,Klarer Himmel
28/01/2016 22:00,263,125,138,4,11,Klarer Himmel
28/01/2016 23:00,135,71,64,4,15,Klarer Himmel
29/01/2016 00:00,74,33,41,4,13,Klarer Himmel
29/01/2016 01:00,45,17,28,4,17,Klarer Himmel
29/01/2016 02:00,11,2,9,4,20,Klarer Himmel
29/01/2016 03:00,11,3,8,5,20,Klarer Himmel
29/01/2016 04:00,16,7,9,5,28,wolkig
29/01/2016 05:00,56,26,30,5,22,wolkig
29/01/2016 06:00,231,105,126,6,24,wolkig
29/01/2016 07:00,803,550,253,6,28,wolkig
29/01/2016 08:00,707,510,197,6,26,wolkig
29/01/2016 09:00,626,448,178,7,28,wolkig
29/01/2016 10:00,609,360,249,7,30,wolkig
29/01/2016 11:00,605,325,280,8,33,wolkig
29/01/2016 12:00,680,298,382,8,32,wolkig
29/01/2016 13:00,714,344,370,9,33,wolkig
29/01/2016 14:00,696,301,395,9,32,wolkig
29/01/2016 15:00,717,307,410,9,39,wolkig
29/01/2016 16:00,655,274,381,9,33,wolkig
29/01/2016 17:00,681,286,395,9,33,wolkig
29/01/2016 18:00,574,221,353,9,33,wolkig
29/01/2016 19:00,483,212,271,9,30,wolkig
29/01/2016 20:00,352,158,194,8,32,wolkig
29/01/2016 21:00,246,122,124,9,32,Regen
29/01/2016 22:00,207,106,101,9,30,wolkig
29/01/2016 23:00,190,103,87,9,33,Regen
30/01/2016 00:00,153,77,76,9,32,Regen
30/01/2016 01:00,138,78,60,9,35,Regen
30/01/2016 02:00,79,35,44,9,35,wolkig
30/01/2016 03:00,67,37,30,9,41,wolkig
30/01/2016 04:00,35,22,13,8,32,Regen
30/01/2016 05:00,39,26,13,8,28,Regen
30/01/2016 06:00,35,20,15,8,32,Regen
30/01/2016 07:00,76,43,33,8,37,Regen
30/01/2016 08:00,160,94,66,9,33,Regen
30/01/2016 09:00,262,177,85,9,33,Regen
30/01/2016 10:00,233,149,84,9,33,Regen
30/01/2016 11:00,233,133,100,8,33,Regen
30/01/2016 12:00,275,138,137,8,24,Regen
30/01/2016 13:00,240,119,121,7,17,Regen
30/01/2016 14:00,252,111,141,7,32,Regen
30/01/2016 15:00,218,101,117,7,19,Regen
30/01/2016 16:00,248,114,134,6,19,wolkig
30/01/2016 17:00,253,102,151,6,20,wolkig
30/01/2016 18:00,268,123,145,5,20,wolkig
30/01/2016 19:00,298,136,162,4,22,teilweise bewölkt
30/01/2016 20:00,256,130,126,4,19,Klarer Himmel
30/01/2016 21:00,170,88,82,4,22,teilweise bewölkt
30/01/2016 22:00,147,78,69,4,22,Klarer Himmel
30/01/2016 23:00,117,64,53,4,30,teilweise bewölkt
31/01/2016 00:00,108,53,55,3,22,teilweise bewölkt
31/01/2016 01:00,106,55,51,3,22,teilweise bewölkt
31/01/2016 02:00,81,42,39,3,24,Klarer Himmel
31/01/2016 03:00,45,24,21,3,24,Klarer Himmel
31/01/2016 04:00,34,21,13,3,24,Klarer Himmel
31/01/2016 05:00,25,18,7,3,28,teilweise bewölkt
31/01/2016 06:00,22,11,11,3,22,Klarer Himmel
31/01/2016 07:00,35,14,21,3,22,Klarer Himmel
31/01/2016 08:00,57,27,30,3,26,Klarer Himmel
31/01/2016 09:00,143,92,51,4,22,Klarer Himmel
31/01/2016 10:00,188,115,73,4,22,Klarer Himmel
31/01/2016 11:00,190,90,100,5,24,Klarer Himmel
31/01/2016 12:00,214,111,103,6,24,wolkig
31/01/2016 13:00,272,150,122,5,20,wolkig
31/01/2016 14:00,277,137,140,6,20,Regen
31/01/2016 15:00,238,131,107,5,15,Regen
31/01/2016 16:00,242,127,115,5,11,Regen
31/01/2016 17:00,281,153,128,5,9,Regen
31/01/2016 18:00,203,103,100,5,9,Regen
31/01/2016 19:00,244,133,111,5,9,Regen
31/01/2016 20:00,187,102,85,6,7,Regen
31/01/2016 21:00,126,64,62,6,9,wolkig
31/01/2016 22:00,109,69,40,8,22,wolkig
31/01/2016 23:00,53,29,24,9,19,Regen
01/02/2016 00:00,28,18,10,9,20,wolkig
01/02/2016 01:00,10,7,3,9,13,Regen
01/02/2016 02:00,1,1,0,9,15,wolkig
01/02/2016 03:00,3,1,2,10,17,Regen
01/02/2016 04:00,11,5,6,10,20,Regen
01/02/2016 05:00,62,28,34,11,28,Regen
01/02/2016 06:00,244,112,132,11,28,wolkig
01/02/2016 07:00,740,480,260,11,26,Regen
01/02/2016 08:00,671,481,190,11,33,Regen
01/02/2016 09:00,563,434,129,11,28,Regen
01/02/2016 10:00,402,259,143,11,32,Regen
01/02/2016 11:00,426,250,176,11,30,Regen
01/02/2016 12:00,500,220,280,11,39,wolkig
01/02/2016 13:00,525,263,262,11,37,wolkig
01/02/2016 14:00,538,279,259,11,44,wolkig
01/02/2016 15:00,609,297,312,12,39,wolkig
01/02/2016 16:00,805,367,438,11,35,wolkig
01/02/2016 17:00,833,350,483,11,33,Regen
01/02/2016 18:00,729,313,416,11,30,wolkig
01/02/2016 19:00,612,269,343,11,33,wolkig
01/02/2016 20:00,338,149,189,11,32,wolkig
01/02/2016 21:00,258,115,143,11,37,wolkig
01/02/2016 22:00,221,117,104,11,37,Regen
01/02/2016 23:00,102,44,58,12,35,wolkig
02/02/2016 00:00,45,24,21,10,37,Regen
02/02/2016 01:00,30,18,12,11,33,Regen
02/02/2016 02:00,10,7,3,11,32,wolkig
02/02/2016 03:00,5,1,4,10,33,wolkig
02/02/2016 04:00,16,10,6,10,43,teilweise bewölkt
02/02/2016 05:00,66,29,37,10,26,wolkig
02/02/2016 06:00,285,126,159,10,33,wolkig
02/02/2016 07:00,831,555,276,9,33,wolkig
02/02/2016 08:00,779,545,234,10,41,wolkig
02/02/2016 09:00,643,474,169,10,32,wolkig
02/02/2016 10:00,464,312,152,10,33,wolkig
02/02/2016 11:00,462,277,185,10,35,Regen
02/02/2016 12:00,548,269,279,8,50,Regen
02/02/2016 13:00,491,190,301,7,39,Regen
02/02/2016 14:00,540,249,291,8,32,Regen
02/02/2016 15:00,562,249,313,6,24,Regen
02/02/2016 16:00,728,329,399,7,20,teilweise bewölkt
02/02/2016 17:00,886,388,498,7,28,wolkig
02/02/2016 18:00,812,341,471,7,28,wolkig
02/02/2016 19:00,632,247,385,7,37,teilweise bewölkt
02/02/2016 20:00,386,159,227,7,33,teilweise bewölkt
02/02/2016 21:00,277,112,165,7,33,wolkig
02/02/2016 22:00,235,120,115,7,33,Klarer Himmel
02/02/2016 23:00,112,58,54,7,30,Klarer Himmel
03/02/2016 00:00,45,31,14,6,30,teilweise bewölkt
03/02/2016 01:00,17,11,6,6,28,Klarer Himmel
03/02/2016 02:00,10,4,6,5,24,Klarer Himmel
03/02/2016 03:00,4,0,4,5,22,teilweise bewölkt
03/02/2016 04:00,13,7,6,4,20,teilweise bewölkt
03/02/2016 05:00,71,34,37,4,22,wolkig
03/02/2016 06:00,266,110,156,4,20,teilweise bewölkt
03/02/2016 07:00,819,564,255,4,17,teilweise bewölkt
03/02/2016 08:00,854,599,255,4,15,teilweise bewölkt
03/02/2016 09:00,648,481,167,4,26,wolkig
03/02/2016 10:00,561,355,206,5,28,wolkig
03/02/2016 11:00,602,375,227,6,32,wolkig
03/02/2016 12:00,674,336,338,7,33,teilweise bewölkt
03/02/2016 13:00,763,362,401,7,32,teilweise bewölkt
03/02/2016 14:00,712,306,406,6,24,teilweise bewölkt
03/02/2016 15:00,705,333,372,5,30,teilweise bewölkt
03/02/2016 16:00,877,349,528,4,24,wolkig
03/02/2016 17:00,912,403,509,4,28,wolkig
03/02/2016 18:00,852,378,474,5,26,wolkig
03/02/2016 19:00,652,261,391,4,26,wolkig
03/02/2016 20:00,388,172,216,4,26,wolkig
03/02/2016 21:00,292,125,167,3,17,teilweise bewölkt
03/02/2016 22:00,267,130,137,3,17,teilweise bewölkt
03/02/2016 23:00,178,103,75,2,19,teilweise bewölkt
04/02/2016 00:00,89,42,47,3,19,teilweise bewölkt
04/02/2016 01:00,34,14,20,3,15,teilweise bewölkt
04/02/2016 02:00,16,4,12,2,19,teilweise bewölkt
04/02/2016 03:00,23,6,17,3,19,wolkig
04/02/2016 04:00,14,3,11,3,15,Klarer Himmel
04/02/2016 05:00,80,37,43,3,19,wolkig
04/02/2016 06:00,243,97,146,3,19,wolkig
04/02/2016 07:00,767,509,258,3,17,wolkig
04/02/2016 08:00,704,484,220,4,17,Regen
04/02/2016 09:00,543,397,146,3,19,Regen
04/02/2016 10:00,368,220,148,3,15,Regen
04/02/2016 11:00,399,234,165,4,15,Regen
04/02/2016 12:00,445,221,224,4,19,Regen
04/02/2016 13:00,471,211,260,3,13,Regen
04/02/2016 14:00,485,199,286,3,9,Regen
04/02/2016 15:00,604,288,316,3,6,Regen
04/02/2016 16:00,684,317,367,4,4,wolkig
04/02/2016 17:00,728,337,391,3,6,wolkig
04/02/2016 18:00,647,271,376,3,9,wolkig
04/02/2016 19:00,545,243,302,3,11,wolkig
04/02/2016 20:00,389,156,233,3,11,wolkig
04/02/2016 21:00,280,111,169,4,11,wolkig
04/02/2016 22:00,226,103,123,4,11,wolkig
04/02/2016 23:00,141,64,77,4,11,wolkig
05/02/2016 00:00,101,42,59,4,7,wolkig
05/02/2016 01:00,45,9,36,4,11,wolkig
05/02/2016 02:00,26,13,13,4,7,wolkig
05/02/2016 03:00,14,4,10,4,9,wolkig
05/02/2016 04:00,17,5,12,4,11,wolkig
05/02/2016 05:00,53,29,24,4,11,Regen
05/02/2016 06:00,211,96,115,4,11,Regen
05/02/2016 07:00,670,446,224,4,15,Regen
05/02/2016 08:00,592,424,168,4,13,Regen
05/02/2016 09:00,504,346,158,5,13,wolkig
05/02/2016 10:00,430,271,159,6,15,Regen
05/02/2016 11:00,410,228,182,6,13,wolkig
05/02/2016 12:00,486,224,262,8,17,wolkig
05/02/2016 13:00,608,280,328,8,15,wolkig
05/02/2016 14:00,641,283,358,10,15,wolkig
05/02/2016 15:00,654,291,363,10,15,wolkig
05/02/2016 16:00,670,292,378,10,15,wolkig
05/02/2016 17:00,663,297,366,9,15,wolkig
05/02/2016 18:00,555,218,337,10,17,wolkig
05/02/2016 19:00,476,196,280,9,13,wolkig
05/02/2016 20:00,331,153,178,9,13,Regen
05/02/2016 21:00,227,96,131,9,15,wolkig
05/02/2016 22:00,193,115,78,9,11,Regen
05/02/2016 23:00,182,94,88,9,13,wolkig
06/02/2016 00:00,122,57,65,10,15,wolkig
06/02/2016 01:00,109,52,57,9,13,wolkig
06/02/2016 02:00,54,25,29,10,15,wolkig
06/02/2016 03:00,41,18,23,9,11,wolkig
06/02/2016 04:00,27,14,13,9,13,wolkig
06/02/2016 05:00,40,23,17,8,11,teilweise bewölkt
06/02/2016 06:00,65,28,37,8,9,wolkig
06/02/2016 07:00,117,79,38,7,11,wolkig
06/02/2016 08:00,190,120,70,8,19,wolkig
06/02/2016 09:00,359,254,105,8,17,wolkig
06/02/2016 10:00,531,376,155,9,19,wolkig
06/02/2016 11:00,603,354,249,9,19,wolkig
06/02/2016 12:00,640,358,282,10,15,wolkig
06/02/2016 13:00,620,308,312,10,24,wolkig
06/02/2016 14:00,642,276,366,10,17,wolkig
06/02/2016 15:00,582,260,322,11,15,wolkig
06/02/2016 16:00,512,231,281,11,19,wolkig
06/02/2016 17:00,522,222,300,10,13,Klarer Himmel
06/02/2016 18:00,440,164,276,9,13,Klarer Himmel
06/02/2016 19:00,423,176,247,9,15,Klarer Himmel
06/02/2016 20:00,309,129,180,9,17,Klarer Himmel
06/02/2016 21:00,180,87,93,8,11,Klarer Himmel
06/02/2016 22:00,204,108,96,9,11,Klarer Himmel
06/02/2016 23:00,198,100,98,8,15,Klarer Himmel
07/02/2016 00:00,149,71,78,8,17,Klarer Himmel
07/02/2016 01:00,131,72,59,8,17,Klarer Himmel
07/02/2016 02:00,97,49,48,9,15,Klarer Himmel
07/02/2016 03:00,48,25,23,9,19,Klarer Himmel
07/02/2016 04:00,44,21,23,9,17,Klarer Himmel
07/02/2016 05:00,28,15,13,10,19,Klarer Himmel
07/02/2016 06:00,24,12,12,10,20,Klarer Himmel
07/02/2016 07:00,36,16,20,10,20,Regen
07/02/2016 08:00,59,29,30,11,20,wolkig
07/02/2016 09:00,156,91,65,11,24,Regen
07/02/2016 10:00,168,85,83,9,19,wolkig
07/02/2016 11:00,188,114,74,10,22,wolkig
07/02/2016 12:00,255,155,100,10,32,wolkig
07/02/2016 13:00,259,160,99,10,28,wolkig
07/02/2016 14:00,288,158,130,10,28,wolkig
07/02/2016 15:00,282,147,135,9,22,wolkig
07/02/2016 16:00,275,141,134,9,24,wolkig
07/02/2016 17:00,348,162,186,9,22,teilweise bewölkt
07/02/2016 18:00,287,135,152,8,24,teilweise bewölkt
07/02/2016 19:00,260,142,118,8,24,Klarer Himmel
07/02/2016 20:00,194,94,100,8,20,Klarer Himmel
07/02/2016 21:00,143,72,71,7,20,Klarer Himmel
07/02/2016 22:00,142,81,61,7,22,Klarer Himmel
07/02/2016 23:00,77,40,37,7,26,Klarer Himmel
08/02/2016 00:00,52,36,16,6,24,Klarer Himmel
08/02/2016 01:00,34,21,13,7,26,Klarer Himmel
08/02/2016 02:00,20,10,10,7,26,teilweise bewölkt
08/02/2016 03:00,12,6,6,8,28,wolkig
08/02/2016 04:00,62,34,28,8,32,wolkig
08/02/2016 05:00,34,20,14,8,33,Regen
08/02/2016 06:00,87,33,54,8,35,Regen
08/02/2016 07:00,143,64,79,7,28,Regen
08/02/2016 08:00,208,115,93,8,30,wolkig
08/02/2016 09:00,154,89,65,9,26,wolkig
08/02/2016 10:00,212,123,89,9,24,Regen
08/02/2016 11:00,243,129,114,10,39,Regen
08/02/2016 12:00,289,165,124,10,35,wolkig
08/02/2016 13:00,260,134,126,9,39,Regen
08/02/2016 14:00,255,141,114,9,33,wolkig
08/02/2016 15:00,283,138,145,9,39,wolkig
08/02/2016 16:00,315,180,135,9,39,wolkig
08/02/2016 17:00,335,160,175,9,37,wolkig
08/02/2016 18:00,302,147,155,8,39,Regen
08/02/2016 19:00,227,119,108,7,39,Regen
08/02/2016 20:00,165,84,81,7,43,Regen
08/02/2016 21:00,136,74,62,8,46,Regen
08/02/2016 22:00,130,80,50,7,41,Regen
08/02/2016 23:00,63,23,40,7,43,Regen
09/02/2016 00:00,40,19,21,7,43,Regen
09/02/2016 01:00,13,7,6,7,41,Regen
09/02/2016 02:00,6,4,2,7,35,wolkig
09/02/2016 03:00,9,5,4,7,39,wolkig
09/02/2016 04:00,11,4,7,6,32,Regen
09/02/2016 05:00,52,25,27,7,30,teilweise bewölkt
09/02/2016 06:00,182,88,94,7,32,wolkig
09/02/2016 07:00,517,311,206,7,30,
09/02/2016 08:00,608,429,179,6,24,Regen
09/02/2016 09:00,573,417,156,7,15,wolkig
09/02/2016 10:00,460,283,177,7,19,wolkig
09/02/2016 11:00,486,299,187,8,17,wolkig
09/02/2016 12:00,499,252,247,8,13,wolkig
09/02/2016 13:00,366,165,201,6,19,Regen
09/02/2016 14:00,347,153,194,4,13,Regen
09/02/2016 15:00,370,155,215,5,11,Regen
09/02/2016 16:00,457,208,249,5,11,Regen
09/02/2016 17:00,651,289,362,6,13,wolkig
09/02/2016 18:00,611,245,366,8,33,Regen
09/02/2016 19:00,471,183,288,1,37,Schnee
09/02/2016 20:00,265,111,154,0,32,Schnee
09/02/2016 21:00,187,86,101,1,22,Schnee
09/02/2016 22:00,153,73,80,2,26,teilweise bewölkt
09/02/2016 23:00,110,58,52,3,22,wolkig
10/02/2016 00:00,35,21,14,4,24,teilweise bewölkt
10/02/2016 01:00,20,7,13,4,24,teilweise bewölkt
10/02/2016 02:00,10,6,4,3,19,teilweise bewölkt
10/02/2016 03:00,5,4,1,4,22,wolkig
10/02/2016 04:00,10,5,5,4,20,wolkig
10/02/2016 05:00,55,33,22,4,17,wolkig
10/02/2016 06:00,205,89,116,1,19,Schnee
10/02/2016 07:00,558,362,196,1,15,Schnee
10/02/2016 08:00,623,426,197,2,11,wolkig
10/02/2016 09:00,493,345,148,3,17,wolkig
10/02/2016 10:00,457,303,154,4,17,wolkig
10/02/2016 11:00,488,275,213,4,17,Regen
10/02/2016 12:00,518,266,252,5,20,wolkig
10/02/2016 13:00,557,297,260,5,24,wolkig
10/02/2016 14:00,507,254,253,6,24,wolkig
10/02/2016 15:00,609,281,328,6,17,wolkig
10/02/2016 16:00,743,310,433,6,19,Regen
10/02/2016 17:00,728,322,406,5,19,Regen
10/02/2016 18:00,646,265,381,5,20,Regen
10/02/2016 19:00,530,221,309,5,20,wolkig
10/02/2016 20:00,340,129,211,5,20,wolkig
10/02/2016 21:00,229,92,137,5,26,wolkig
10/02/2016 22:00,259,134,125,4,20,wolkig
10/02/2016 23:00,124,54,70,3,20,teilweise bewölkt
11/02/2016 00:00,58,30,28,4,20,teilweise bewölkt
11/02/2016 01:00,33,14,19,4,20,wolkig
11/02/2016 02:00,16,9,7,4,19,Klarer Himmel
11/02/2016 03:00,9,1,8,4,17,Klarer Himmel
11/02/2016 04:00,14,4,10,3,17,wolkig
11/02/2016 05:00,68,34,34,3,17,wolkig
11/02/2016 06:00,258,106,152,3,20,wolkig
11/02/2016 07:00,748,489,259,3,17,wolkig
11/02/2016 08:00,686,485,201,4,17,teilweise bewölkt
11/02/2016 09:00,643,474,169,4,17,teilweise bewölkt
11/02/2016 10:00,500,332,168,5,20,teilweise bewölkt
11/02/2016 11:00,558,302,256,6,19,teilweise bewölkt
11/02/2016 12:00,628,318,310,6,26,teilweise bewölkt
11/02/2016 13:00,672,327,345,6,28,teilweise bewölkt
11/02/2016 14:00,692,327,365,7,24,teilweise bewölkt
11/02/2016 15:00,751,335,416,7,24,teilweise bewölkt
11/02/2016 16:00,865,385,480,6,15,teilweise bewölkt
11/02/2016 17:00,914,414,500,6,9,wolkig
11/02/2016 18:00,790,326,464,4,7,wolkig
11/02/2016 19:00,650,276,374,4,7,wolkig
11/02/2016 20:00,390,176,214,4,7,wolkig
11/02/2016 21:00,289,126,163,3,6,wolkig
11/02/2016 22:00,240,132,108,2,4,wolkig
11/02/2016 23:00,152,72,80,4,6,wolkig
12/02/2016 00:00,79,44,35,3,4,wolkig
12/02/2016 01:00,21,13,8,3,7,wolkig
12/02/2016 02:00,15,6,9,1,4,teilweise bewölkt
12/02/2016 03:00,13,4,9,2,6,wolkig
12/02/2016 04:00,9,5,4,2,6,Nebel
12/02/2016 05:00,59,24,35,1,4,wolkig
12/02/2016 06:00,243,108,135,1,4,wolkig
12/02/2016 07:00,760,514,246,1,4,Nebel
12/02/2016 08:00,663,460,203,2,6,wolkig
12/02/2016 09:00,581,403,178,2,6,wolkig
12/02/2016 10:00,489,320,169,3,6,wolkig
12/02/2016 11:00,521,302,219,4,15,wolkig
12/02/2016 12:00,615,301,314,5,9,wolkig
12/02/2016 13:00,794,387,407,6,11,wolkig
12/02/2016 14:00,819,406,413,6,11,wolkig
12/02/2016 15:00,814,385,429,6,7,wolkig
12/02/2016 16:00,823,361,462,5,6,teilweise bewölkt
12/02/2016 17:00,753,348,405,4,6,wolkig
12/02/2016 18:00,633,225,408,3,6,teilweise bewölkt
12/02/2016 19:00,548,231,317,2,7,teilweise bewölkt
12/02/2016 20:00,388,169,219,1,6,Klarer Himmel
12/02/2016 21:00,289,133,156,1,7,Klarer Himmel
12/02/2016 22:00,272,133,139,0,6,Klarer Himmel
12/02/2016 23:00,221,103,118,0,6,Klarer Himmel
13/02/2016 00:00,165,90,75,0,7,Klarer Himmel
13/02/2016 01:00,128,62,66,-1,4,Klarer Himmel
13/02/2016 02:00,79,50,29,-2,4,Klarer Himmel
13/02/2016 03:00,61,34,27,-1,6,Klarer Himmel
13/02/2016 04:00,37,27,10,-2,4,Klarer Himmel
13/02/2016 05:00,46,30,16,-2,6,Nebel
13/02/2016 06:00,54,30,24,-2,6,Nebel
13/02/2016 07:00,105,64,41,-2,6,Klarer Himmel
13/02/2016 08:00,211,124,87,-1,7,Klarer Himmel
13/02/2016 09:00,366,259,107,1,9,Klarer Himmel
13/02/2016 10:00,529,353,176,4,7,Klarer Himmel
13/02/2016 11:00,567,320,247,4,11,Klarer Himmel
13/02/2016 12:00,688,389,299,5,9,Klarer Himmel
13/02/2016 13:00,715,392,323,7,13,Klarer Himmel
13/02/2016 14:00,642,295,347,7,15,Klarer Himmel
13/02/2016 15:00,613,254,359,6,13,Klarer Himmel
13/02/2016 16:00,551,236,315,6,9,Klarer Himmel
13/02/2016 17:00,513,214,299,5,7,Klarer Himmel
13/02/2016 18:00,474,193,281,5,6,wolkig
13/02/2016 19:00,412,161,251,5,9,wolkig
13/02/2016 20:00,307,133,174,4,9,wolkig
13/02/2016 21:00,202,111,91,4,9,Regen
13/02/2016 22:00,171,111,60,4,9,Regen
13/02/2016 23:00,155,65,90,3,9,Schnee
14/02/2016 00:00,149,73,76,3,9,Schnee
14/02/2016 01:00,120,44,76,2,11,Schnee
14/02/2016 02:00,71,37,34,2,13,Schnee
14/02/2016 03:00,61,33,28,2,15,Schnee
14/02/2016 04:00,30,16,14,2,15,Schnee
14/02/2016 05:00,33,19,14,1,11,Schnee
14/02/2016 06:00,37,21,16,2,9,Schnee
14/02/2016 07:00,22,8,14,2,13,Schnee
14/02/2016 08:00,45,24,21,2,13,Schnee
14/02/2016 09:00,143,96,47,2,17,Schnee
14/02/2016 10:00,144,79,65,2,15,Schnee
14/02/2016 11:00,135,58,77,2,17,Schnee
14/02/2016 12:00,190,99,91,2,13,Schnee
14/02/2016 13:00,221,134,87,2,13,Regen
14/02/2016 14:00,225,117,108,2,6,Schnee
14/02/2016 15:00,219,126,93,1,7,Regen
14/02/2016 16:00,211,107,104,0,4,Schnee
14/02/2016 17:00,263,144,119,0,6,Schnee
14/02/2016 18:00,226,114,112,0,6,Schnee
14/02/2016 19:00,191,111,80,0,6,Schnee
14/02/2016 20:00,157,77,80,0,6,Schnee
14/02/2016 21:00,123,59,64,1,7,Schnee
14/02/2016 22:00,126,65,61,0,11,Schnee
14/02/2016 23:00,44,28,16,1,11,Schnee
15/02/2016 00:00,20,10,10,1,9,Schnee
15/02/2016 01:00,8,3,5,1,9,Schnee
15/02/2016 02:00,2,2,0,1,17,Schnee
15/02/2016 03:00,4,1,3,1,17,Schnee
15/02/2016 04:00,11,5,6,1,17,Schnee
15/02/2016 05:00,54,25,29,1,17,Schnee
15/02/2016 06:00,194,95,99,0,19,Schnee
15/02/2016 07:00,679,451,228,0,19,Schnee
15/02/2016 08:00,560,381,179,1,19,Schnee
15/02/2016 09:00,386,282,104,1,19,Schnee
15/02/2016 10:00,284,189,95,1,22,wolkig
15/02/2016 11:00,364,216,148,1,20,wolkig
15/02/2016 12:00,429,219,210,1,19,wolkig
15/02/2016 13:00,446,237,209,1,22,wolkig
15/02/2016 14:00,478,241,237,1,22,wolkig
15/02/2016 15:00,555,258,297,1,20,wolkig
15/02/2016 16:00,654,291,363,1,15,wolkig
15/02/2016 17:00,717,341,376,0,7,teilweise bewölkt
15/02/2016 18:00,666,262,404,0,15,teilweise bewölkt
15/02/2016 19:00,519,222,297,0,11,wolkig
15/02/2016 20:00,323,144,179,-1,6,teilweise bewölkt
15/02/2016 21:00,196,107,89,-2,2,wolkig
15/02/2016 22:00,174,79,95,-2,4,wolkig
15/02/2016 23:00,127,64,63,-3,2,wolkig
16/02/2016 00:00,40,25,15,-3,6,wolkig
16/02/2016 01:00,38,25,13,-2,2,wolkig
16/02/2016 02:00,8,3,5,-3,4,teilweise bewölkt
16/02/2016 03:00,9,3,6,-3,2,wolkig
16/02/2016 04:00,12,6,6,-5,2,Nebel
16/02/2016 05:00,61,28,33,-5,2,Nebel
16/02/2016 06:00,268,122,146,-5,2,Nebel
16/02/2016 07:00,784,502,282,-6,2,Nebel
16/02/2016 08:00,715,485,230,-4,2,Nebel
16/02/2016 09:00,521,376,145,-2,2,
16/02/2016 10:00,425,267,158,1,2,Klarer Himmel
16/02/2016 11:00,420,229,191,2,4,teilweise bewölkt
16/02/2016 12:00,536,286,250,2,9,teilweise bewölkt
16/02/2016 13:00,581,269,312,4,4,teilweise bewölkt
16/02/2016 14:00,674,334,340,3,7,Klarer Himmel
16/02/2016 15:00,664,312,352,3,6,Klarer Himmel
16/02/2016 16:00,771,350,421,2,7,Klarer Himmel
16/02/2016 17:00,879,388,491,1,6,
16/02/2016 18:00,762,343,419,0,6,Klarer Himmel
16/02/2016 19:00,672,279,393,-1,6,Klarer Himmel
16/02/2016 20:00,334,127,207,-1,6,Klarer Himmel
16/02/2016 21:00,281,140,141,-2,6,Klarer Himmel
16/02/2016 22:00,261,157,104,-2,9,Klarer Himmel
16/02/2016 23:00,116,61,55,-2,7,Klarer Himmel
17/02/2016 00:00,58,36,22,-2,6,Klarer Himmel
17/02/2016 01:00,33,18,15,-3,4,Klarer Himmel
17/02/2016 02:00,11,4,7,-3,4,Klarer Himmel
17/02/2016 03:00,9,3,6,-4,6,Klarer Himmel
17/02/2016 04:00,14,8,6,-4,11,Klarer Himmel
17/02/2016 05:00,67,37,30,-3,7,Klarer Himmel
17/02/2016 06:00,246,108,138,-3,11,Klarer Himmel
17/02/2016 07:00,809,536,273,-3,4,Klarer Himmel
17/02/2016 08:00,690,468,222,-2,7,Klarer Himmel
17/02/2016 09:00,532,379,153,0,9,Klarer Himmel
17/02/2016 10:00,501,316,185,1,13,Klarer Himmel
17/02/2016 11:00,467,265,202,2,15,teilweise bewölkt
17/02/2016 12:00,584,302,282,3,11,teilweise bewölkt
17/02/2016 13:00,591,268,323,2,9,wolkig
17/02/2016 14:00,575,269,306,3,9,teilweise bewölkt
17/02/2016 15:00,652,293,359,3,11,wolkig
17/02/2016 16:00,765,341,424,2,9,teilweise bewölkt
17/02/2016 17:00,899,433,466,1,4,teilweise bewölkt
17/02/2016 18:00,743,303,440,-1,2,teilweise bewölkt
17/02/2016 19:00,565,238,327,-2,4,teilweise bewölkt
17/02/2016 20:00,401,164,237,-3,0,Klarer Himmel
17/02/2016 21:00,247,106,141,-3,0,Nebel
17/02/2016 22:00,278,153,125,-4,0,Nebel
17/02/2016 23:00,129,77,52,-3,4,Nebel
18/02/2016 00:00,67,39,28,-4,0,Nebel
18/02/2016 01:00,31,18,13,-2,6,
18/02/2016 02:00,26,7,19,-2,2,wolkig
18/02/2016 03:00,17,3,14,-1,4,wolkig
18/02/2016 04:00,19,6,13,-1,4,wolkig
18/02/2016 05:00,63,29,34,-1,2,wolkig
18/02/2016 06:00,262,129,133,0,7,Schnee
18/02/2016 07:00,776,510,266,0,7,Schnee
18/02/2016 08:00,716,473,243,1,9,Schnee
18/02/2016 09:00,504,358,146,1,7,wolkig
18/02/2016 10:00,387,251,136,2,6,wolkig
18/02/2016 11:00,456,256,200,3,15,Klarer Himmel
18/02/2016 12:00,554,278,276,4,11,wolkig
18/02/2016 13:00,588,278,310,4,17,wolkig
18/02/2016 14:00,590,277,313,5,19,wolkig
18/02/2016 15:00,687,312,375,5,11,wolkig
18/02/2016 16:00,785,342,443,4,9,wolkig
18/02/2016 17:00,871,427,444,2,2,Klarer Himmel
18/02/2016 18:00,765,360,405,0,2,Klarer Himmel
18/02/2016 19:00,573,244,329,0,4,wolkig
18/02/2016 20:00,332,130,202,0,4,wolkig
18/02/2016 21:00,277,117,160,0,2,wolkig
18/02/2016 22:00,249,126,123,0,6,wolkig
18/02/2016 23:00,161,82,79,0,2,wolkig
19/02/2016 00:00,60,33,27,0,2,Klarer Himmel
19/02/2016 01:00,18,7,11,0,2,wolkig
19/02/2016 02:00,13,7,6,0,2,wolkig
19/02/2016 03:00,11,3,8,0,6,Klarer Himmel
19/02/2016 04:00,11,6,5,0,2,Klarer Himmel
19/02/2016 05:00,70,33,37,0,2,wolkig
19/02/2016 06:00,235,100,135,0,4,wolkig
19/02/2016 07:00,752,520,232,1,4,Schnee
19/02/2016 08:00,641,434,207,1,6,Schnee
19/02/2016 09:00,449,319,130,2,9,
19/02/2016 10:00,447,284,163,2,9,wolkig
19/02/2016 11:00,450,257,193,3,11,wolkig
19/02/2016 12:00,585,284,301,3,19,Regen
19/02/2016 13:00,726,312,414,3,13,Regen
19/02/2016 14:00,683,320,363,3,9,wolkig
19/02/2016 15:00,674,302,372,3,13,wolkig
19/02/2016 16:00,640,297,343,3,9,wolkig
19/02/2016 17:00,654,301,353,3,7,wolkig
19/02/2016 18:00,611,259,352,1,6,
19/02/2016 19:00,484,179,305,2,11,
19/02/2016 20:00,332,146,186,1,13,
19/02/2016 21:00,232,109,123,1,13,
19/02/2016 22:00,215,104,111,1,13,Klarer Himmel
19/02/2016 23:00,172,96,76,2,15,Klarer Himmel
20/02/2016 00:00,158,76,82,2,17,Klarer Himmel
20/02/2016 01:00,132,71,61,3,20,Klarer Himmel
20/02/2016 02:00,62,34,28,4,20,Klarer Himmel
20/02/2016 03:00,59,28,31,4,22,Regen
20/02/2016 04:00,35,20,15,4,26,Regen
20/02/2016 05:00,53,34,19,5,30,wolkig
20/02/2016 06:00,32,17,15,4,26,Regen
20/02/2016 07:00,99,58,41,4,24,Regen
20/02/2016 08:00,188,122,66,5,24,Regen
20/02/2016 09:00,247,174,73,5,22,Regen
20/02/2016 10:00,289,181,108,6,20,Regen
20/02/2016 11:00,324,197,127,7,24,Regen
20/02/2016 12:00,362,192,170,8,22,wolkig
20/02/2016 13:00,389,186,203,8,22,wolkig
20/02/2016 14:00,373,176,197,9,28,wolkig
20/02/2016 15:00,362,181,181,9,24,wolkig
20/02/2016 16:00,324,137,187,9,24,Regen
20/02/2016 17:00,286,108,178,8,30,Regen
20/02/2016 18:00,316,131,185,7,19,Regen
20/02/2016 19:00,261,120,141,8,20,wolkig
20/02/2016 20:00,216,103,113,7,15,Regen
20/02/2016 21:00,153,71,82,9,28,Regen
20/02/2016 22:00,146,77,69,9,30,Regen
20/02/2016 23:00,98,55,43,10,35,Regen
21/02/2016 00:00,110,61,49,10,39,Regen
21/02/2016 01:00,110,57,53,10,30,Regen
21/02/2016 02:00,74,37,37,8,26,Regen
21/02/2016 03:00,57,26,31,8,24,Regen
21/02/2016 04:00,52,32,20,8,24,Regen
21/02/2016 05:00,27,23,4,8,20,wolkig
21/02/2016 06:00,25,13,12,8,28,wolkig
21/02/2016 07:00,31,13,18,8,19,Regen
21/02/2016 08:00,47,24,23,8,17,Regen
21/02/2016 09:00,86,48,38,8,11,Regen
21/02/2016 10:00,120,63,57,8,11,Regen
21/02/2016 11:00,120,64,56,11,30,Regen
21/02/2016 12:00,149,73,76,11,32,Regen
21/02/2016 13:00,165,86,79,11,37,Regen
21/02/2016 14:00,201,108,93,11,37,Regen
21/02/2016 15:00,173,98,75,11,37,Regen
21/02/2016 16:00,189,112,77,11,30,Regen
21/02/2016 17:00,220,115,105,12,39,wolkig
21/02/2016 18:00,197,85,112,12,35,Regen
21/02/2016 19:00,194,107,87,12,41,Regen
21/02/2016 20:00,158,92,66,11,33,Regen
21/02/2016 21:00,104,58,46,12,44,Regen
21/02/2016 22:00,105,68,37,11,44,Regen
21/02/2016 23:00,50,32,18,11,41,Regen
22/02/2016 00:00,23,15,8,11,43,Regen
22/02/2016 01:00,14,8,6,11,43,wolkig
22/02/2016 02:00,2,1,1,10,39,Regen
22/02/2016 03:00,5,1,4,10,41,Regen
22/02/2016 04:00,12,4,8,10,28,Regen
22/02/2016 05:00,64,32,32,10,26,Regen
22/02/2016 06:00,211,99,112,9,30,Regen
22/02/2016 07:00,616,395,221,9,20,Regen
22/02/2016 08:00,495,327,168,7,7,Regen
22/02/2016 09:00,379,275,104,7,11,Regen
22/02/2016 10:00,282,166,116,6,17,Regen
22/02/2016 11:00,276,139,137,6,13,Regen
22/02/2016 12:00,329,164,165,6,13,Regen
22/02/2016 13:00,386,193,193,6,17,Regen
22/02/2016 14:00,377,206,171,5,19,Regen
22/02/2016 15:00,388,166,222,5,26,Regen
22/02/2016 16:00,548,239,309,5,15,wolkig
22/02/2016 17:00,636,298,338,5,15,Regen
22/02/2016 18:00,582,253,329,5,17,Regen
22/02/2016 19:00,432,202,230,5,17,Regen
22/02/2016 20:00,274,117,157,4,19,wolkig
22/02/2016 21:00,207,87,120,4,15,wolkig
22/02/2016 22:00,198,100,98,4,17,wolkig
22/02/2016 23:00,76,42,34,4,15,wolkig
23/02/2016 00:00,45,23,22,4,15,wolkig
23/02/2016 01:00,20,11,9,4,15,wolkig
23/02/2016 02:00,9,4,5,4,15,wolkig
23/02/2016 03:00,7,3,4,4,15,wolkig
23/02/2016 04:00,16,6,10,4,9,wolkig
23/02/2016 05:00,67,33,34,3,11,wolkig
23/02/2016 06:00,296,125,171,3,11,wolkig
23/02/2016 07:00,807,502,305,3,11,teilweise bewölkt
23/02/2016 08:00,682,467,215,4,7,teilweise bewölkt
23/02/2016 09:00,578,411,167,5,19,teilweise bewölkt
23/02/2016 10:00,452,249,203,6,17,teilweise bewölkt
23/02/2016 11:00,462,272,190,6,20,teilweise bewölkt
23/02/2016 12:00,591,298,293,8,20,teilweise bewölkt
23/02/2016 13:00,635,304,331,8,22,wolkig
23/02/2016 14:00,588,316,272,7,19,Regen
23/02/2016 15:00,626,296,330,6,13,wolkig
23/02/2016 16:00,786,368,418,6,20,teilweise bewölkt
23/02/2016 17:00,925,426,499,5,17,teilweise bewölkt
23/02/2016 18:00,799,348,451,4,17,teilweise bewölkt
23/02/2016 19:00,596,271,325,4,17,wolkig
23/02/2016 20:00,358,146,212,4,15,wolkig
23/02/2016 21:00,267,121,146,3,15,teilweise bewölkt
23/02/2016 22:00,253,108,145,2,13,teilweise bewölkt
23/02/2016 23:00,104,50,54,2,15,teilweise bewölkt
24/02/2016 00:00,57,27,30,1,13,Klarer Himmel
24/02/2016 01:00,22,12,10,1,13,Klarer Himmel
24/02/2016 02:00,9,5,4,1,13,Klarer Himmel
24/02/2016 03:00,10,4,6,1,9,teilweise bewölkt
24/02/2016 04:00,22,4,18,1,13,teilweise bewölkt
24/02/2016 05:00,80,39,41,0,7,wolkig
24/02/2016 06:00,287,139,148,0,9,
24/02/2016 07:00,832,525,307,0,9,Nebel
24/02/2016 08:00,739,517,222,1,9,
24/02/2016 09:00,550,366,184,3,13,Klarer Himmel
24/02/2016 10:00,522,339,183,4,17,teilweise bewölkt
24/02/2016 11:00,540,316,224,5,19,teilweise bewölkt
24/02/2016 12:00,600,329,271,7,19,teilweise bewölkt
24/02/2016 13:00,694,319,375,7,19,teilweise bewölkt
24/02/2016 14:00,629,293,336,5,15,Klarer Himmel
24/02/2016 15:00,685,319,366,6,20,Klarer Himmel
24/02/2016 16:00,766,324,442,5,9,Klarer Himmel
24/02/2016 17:00,869,434,435,4,9,Klarer Himmel
24/02/2016 18:00,741,334,407,3,6,Klarer Himmel
24/02/2016 19:00,632,252,380,4,6,wolkig
24/02/2016 20:00,355,151,204,2,6,wolkig
24/02/2016 21:00,293,124,169,2,7,wolkig
24/02/2016 22:00,291,148,143,2,7,Klarer Himmel
24/02/2016 23:00,160,91,69,1,6,Klarer Himmel
25/02/2016 00:00,79,38,41,0,7,Klarer Himmel
25/02/2016 01:00,57,20,37,0,7,Klarer Himmel
25/02/2016 02:00,30,21,9,0,9,Klarer Himmel
25/02/2016 03:00,34,25,9,-1,4,Klarer Himmel
25/02/2016 04:00,42,27,15,-2,4,Nebel
25/02/2016 05:00,91,40,51,-2,4,Nebel
25/02/2016 06:00,284,129,155,-1,9,Nebel
25/02/2016 07:00,805,520,285,-1,7,Nebel
25/02/2016 08:00,725,484,241,0,9,teilweise bewölkt
25/02/2016 09:00,555,403,152,2,15,teilweise bewölkt
25/02/2016 10:00,400,244,156,3,17,teilweise bewölkt
25/02/2016 11:00,451,254,197,5,22,teilweise bewölkt
25/02/2016 12:00,547,263,284,5,24,teilweise bewölkt
25/02/2016 13:00,633,301,332,4,26,teilweise bewölkt
25/02/2016 14:00,650,332,318,6,19,teilweise bewölkt
25/02/2016 15:00,679,290,389,4,19,Regen
25/02/2016 16:00,755,350,405,3,19,teilweise bewölkt
25/02/2016 17:00,827,396,431,2,13,Regen
25/02/2016 18:00,714,320,394,2,15,teilweise bewölkt
25/02/2016 19:00,527,230,297,1,11,Klarer Himmel
25/02/2016 20:00,339,154,185,1,11,Klarer Himmel
25/02/2016 21:00,231,89,142,0,9,Klarer Himmel
25/02/2016 22:00,222,100,122,0,7,teilweise bewölkt
25/02/2016 23:00,137,61,76,0,9,wolkig
26/02/2016 00:00,53,30,23,0,9,teilweise bewölkt
26/02/2016 01:00,33,21,12,0,9,Nebel
26/02/2016 02:00,13,6,7,-1,9,Nebel
26/02/2016 03:00,11,2,9,-1,7,Nebel
26/02/2016 04:00,17,7,10,-1,7,teilweise bewölkt
26/02/2016 05:00,74,33,41,-1,9,Nebel
26/02/2016 06:00,242,109,133,-1,9,wolkig
26/02/2016 07:00,757,504,253,-1,9,wolkig
26/02/2016 08:00,621,428,193,-1,7,wolkig
26/02/2016 09:00,492,359,133,0,6,wolkig
26/02/2016 10:00,395,248,147,0,7,wolkig
26/02/2016 11:00,474,266,208,1,9,wolkig
26/02/2016 12:00,621,295,326,2,7,wolkig
26/02/2016 13:00,709,329,380,3,7,teilweise bewölkt
26/02/2016 14:00,754,351,403,4,4,teilweise bewölkt
26/02/2016 15:00,747,355,392,4,2,wolkig
26/02/2016 16:00,697,306,391,4,4,wolkig
26/02/2016 17:00,682,319,363,3,6,Klarer Himmel
26/02/2016 18:00,597,262,335,2,4,Klarer Himmel
26/02/2016 19:00,489,225,264,1,4,Klarer Himmel
26/02/2016 20:00,308,160,148,1,4,Klarer Himmel
26/02/2016 21:00,247,100,147,1,4,Klarer Himmel
26/02/2016 22:00,225,117,108,1,4,Klarer Himmel
26/02/2016 23:00,187,85,102,0,6,wolkig
27/02/2016 00:00,137,60,77,-1,4,
27/02/2016 01:00,97,37,60,-1,4,
27/02/2016 02:00,68,37,31,0,4,Klarer Himmel
27/02/2016 03:00,55,33,22,-1,6,Klarer Himmel
27/02/2016 04:00,39,30,9,-1,6,Klarer Himmel
27/02/2016 05:00,39,27,12,-1,6,Klarer Himmel
27/02/2016 06:00,48,26,22,-1,4,Klarer Himmel
27/02/2016 07:00,104,60,44,-2,6,Klarer Himmel
27/02/2016 08:00,183,108,75,0,7,Klarer Himmel
27/02/2016 09:00,411,282,129,2,11,Klarer Himmel
27/02/2016 10:00,509,328,181,4,13,Klarer Himmel
27/02/2016 11:00,572,386,186,4,17,Klarer Himmel
27/02/2016 12:00,692,400,292,5,22,teilweise bewölkt
27/02/2016 13:00,660,309,351,6,22,teilweise bewölkt
27/02/2016 14:00,656,302,354,5,22,teilweise bewölkt
27/02/2016 15:00,586,255,331,5,20,teilweise bewölkt
27/02/2016 16:00,507,222,285,5,15,teilweise bewölkt
27/02/2016 17:00,435,173,262,4,15,teilweise bewölkt
27/02/2016 18:00,460,187,273,1,9,Klarer Himmel
27/02/2016 19:00,399,184,215,0,9,Klarer Himmel
27/02/2016 20:00,270,123,147,0,11,Klarer Himmel
27/02/2016 21:00,206,104,102,1,13,Klarer Himmel
27/02/2016 22:00,182,88,94,0,11,Klarer Himmel
27/02/2016 23:00,175,79,96,0,15,Klarer Himmel
28/02/2016 00:00,207,109,98,0,11,Klarer Himmel
28/02/2016 01:00,154,62,92,-2,9,Klarer Himmel
28/02/2016 02:00,89,53,36,-2,11,Klarer Himmel
28/02/2016 03:00,68,39,29,-2,9,Klarer Himmel
28/02/2016 04:00,42,27,15,-3,9,Klarer Himmel
28/02/2016 05:00,51,35,16,-3,11,Klarer Himmel
28/02/2016 06:00,33,18,15,-3,7,Klarer Himmel
28/02/2016 07:00,49,27,22,-2,9,Klarer Himmel
28/02/2016 08:00,58,29,29,0,13,Klarer Himmel
28/02/2016 09:00,159,96,63,1,17,Klarer Himmel
28/02/2016 10:00,213,115,98,3,20,Klarer Himmel
28/02/2016 11:00,205,114,91,4,20,Klarer Himmel
28/02/2016 12:00,270,143,127,5,28,Klarer Himmel
28/02/2016 13:00,310,168,142,6,19,teilweise bewölkt
28/02/2016 14:00,370,197,173,6,20,Klarer Himmel
28/02/2016 15:00,348,180,168,5,26,Klarer Himmel
28/02/2016 16:00,274,151,123,5,17,Klarer Himmel
28/02/2016 17:00,342,182,160,4,17,Klarer Himmel
28/02/2016 18:00,296,153,143,3,17,Klarer Himmel
28/02/2016 19:00,241,134,107,2,7,Klarer Himmel
28/02/2016 20:00,168,84,84,-1,7,Klarer Himmel
28/02/2016 21:00,153,91,62,1,15,Klarer Himmel
28/02/2016 22:00,126,79,47,0,7,Klarer Himmel
28/02/2016 23:00,60,27,33,-1,9,Klarer Himmel
29/02/2016 00:00,27,19,8,0,13,Klarer Himmel
29/02/2016 01:00,17,7,10,-1,11,Klarer Himmel
29/02/2016 02:00,4,1,3,-1,15,Klarer Himmel
29/02/2016 03:00,7,1,6,-2,11,Klarer Himmel
29/02/2016 04:00,18,6,12,-2,9,Klarer Himmel
29/02/2016 05:00,69,35,34,-2,11,Klarer Himmel
29/02/2016 06:00,285,133,152,-2,13,Klarer Himmel
29/02/2016 07:00,816,535,281,-2,13,Klarer Himmel
29/02/2016 08:00,730,497,233,0,15,Klarer Himmel
29/02/2016 09:00,557,402,155,1,19,Klarer Himmel
29/02/2016 10:00,438,292,146,3,19,Klarer Himmel
29/02/2016 11:00,483,260,223,4,20,Klarer Himmel
29/02/2016 12:00,617,314,303,4,22,Klarer Himmel
29/02/2016 13:00,586,275,311,5,19,teilweise bewölkt
29/02/2016 14:00,655,329,326,5,19,Klarer Himmel
29/02/2016 15:00,724,334,390,5,20,Klarer Himmel
29/02/2016 16:00,782,331,451,4,20,teilweise bewölkt
29/02/2016 17:00,893,413,480,2,17,Klarer Himmel
29/02/2016 18:00,750,328,422,1,13,Klarer Himmel
29/02/2016 19:00,541,235,306,0,11,Klarer Himmel
29/02/2016 20:00,386,154,232,0,13,Klarer Himmel
29/02/2016 21:00,246,115,131,-1,7,Klarer Himmel
29/02/2016 22:00,219,110,109,-2,4,Klarer Himmel
29/02/2016 23:00,111,60,51,-3,2,
01/03/2016 00:00,53,33,20,-3,0,
01/03/2016 01:00,17,10,7,-4,4,
01/03/2016 02:00,7,3,4,-5,2,
01/03/2016 03:00,8,2,6,-5,2,Nebel
01/03/2016 04:00,17,7,10,-5,2,Nebel
01/03/2016 05:00,71,30,41,-6,2,Nebel
01/03/2016 06:00,295,136,159,-5,0,Nebel
01/03/2016 07:00,802,514,288,-5,4,Nebel
01/03/2016 08:00,731,515,216,-3,6,
01/03/2016 09:00,548,394,154,-1,9,
01/03/2016 10:00,448,274,174,1,13,
01/03/2016 11:00,426,246,180,2,13,Klarer Himmel
01/03/2016 12:00,539,271,268,3,17,Klarer Himmel
01/03/2016 13:00,556,247,309,4,20,wolkig
01/03/2016 14:00,614,286,328,4,17,wolkig
01/03/2016 15:00,596,272,324,4,20,Regen
01/03/2016 16:00,777,354,423,3,20,Regen
01/03/2016 17:00,771,316,455,2,17,Regen
01/03/2016 18:00,680,301,379,2,17,Regen
01/03/2016 19:00,540,236,304,3,20,Regen
01/03/2016 20:00,273,127,146,3,19,Regen
01/03/2016 21:00,225,106,119,3,20,Regen
01/03/2016 22:00,210,123,87,4,22,wolkig
01/03/2016 23:00,102,50,52,5,24,wolkig
02/03/2016 00:00,55,36,19,5,20,wolkig
02/03/2016 01:00,28,11,17,5,17,wolkig
02/03/2016 02:00,12,4,8,5,15,Regen
02/03/2016 03:00,10,5,5,6,20,Regen
02/03/2016 04:00,9,3,6,6,19,Regen
02/03/2016 05:00,62,34,28,7,20,wolkig
02/03/2016 06:00,255,118,137,7,24,wolkig
02/03/2016 07:00,861,545,316,7,22,wolkig
02/03/2016 08:00,717,488,229,7,28,wolkig
02/03/2016 09:00,515,376,139,7,20,Regen
02/03/2016 10:00,359,220,139,4,28,Regen
02/03/2016 11:00,331,184,147,5,28,wolkig
02/03/2016 12:00,483,256,227,6,28,wolkig
02/03/2016 13:00,587,279,308,7,30,teilweise bewölkt
02/03/2016 14:00,558,251,307,6,28,teilweise bewölkt
02/03/2016 15:00,646,322,324,7,20,teilweise bewölkt
02/03/2016 16:00,691,278,413,6,13,wolkig
02/03/2016 17:00,768,352,416,6,11,wolkig
02/03/2016 18:00,676,294,382,6,11,wolkig
02/03/2016 19:00,541,240,301,5,11,wolkig
02/03/2016 20:00,309,135,174,5,19,Regen
02/03/2016 21:00,214,115,99,4,15,teilweise bewölkt
02/03/2016 22:00,247,116,131,4,17,wolkig
02/03/2016 23:00,109,42,67,4,22,wolkig
03/03/2016 00:00,71,41,30,4,20,wolkig
03/03/2016 01:00,46,16,30,4,20,Regen
03/03/2016 02:00,28,10,18,3,20,Regen
03/03/2016 03:00,28,15,13,3,19,Regen
03/03/2016 04:00,19,10,9,3,19,Regen
03/03/2016 05:00,71,36,35,3,19,Regen
03/03/2016 06:00,267,114,153,3,19,wolkig
03/03/2016 07:00,776,505,271,3,19,wolkig
03/03/2016 08:00,692,489,203,3,17,wolkig
03/03/2016 09:00,531,374,157,4,22,wolkig
03/03/2016 10:00,424,269,155,5,19,wolkig
03/03/2016 11:00,446,255,191,5,19,wolkig
03/03/2016 12:00,521,257,264,6,24,wolkig
03/03/2016 13:00,588,281,307,5,24,wolkig
03/03/2016 14:00,619,308,311,2,20,Regen
03/03/2016 15:00,661,307,354,5,17,wolkig
03/03/2016 16:00,787,360,427,2,17,Regen
03/03/2016 17:00,831,366,465,4,13,teilweise bewölkt
03/03/2016 18:00,732,307,425,3,11,teilweise bewölkt
03/03/2016 19:00,583,242,341,2,7,teilweise bewölkt
03/03/2016 20:00,378,158,220,1,6,Klarer Himmel
03/03/2016 21:00,271,108,163,1,4,Nebel
03/03/2016 22:00,252,144,108,0,4,Nebel
03/03/2016 23:00,158,86,72,-2,7,Nebel
04/03/2016 00:00,112,50,62,-2,6,Nebel
04/03/2016 01:00,52,17,35,0,9,Nebel
04/03/2016 02:00,17,9,8,0,9,Klarer Himmel
04/03/2016 03:00,26,17,9,0,9,Klarer Himmel
04/03/2016 04:00,39,28,11,0,11,Klarer Himmel
04/03/2016 05:00,80,50,30,0,11,
04/03/2016 06:00,251,115,136,0,11,
04/03/2016 07:00,775,518,257,0,9,
04/03/2016 08:00,613,408,205,2,17,wolkig
04/03/2016 09:00,467,317,150,2,15,wolkig
04/03/2016 10:00,440,284,156,3,17,wolkig
04/03/2016 11:00,442,209,233,4,15,wolkig
04/03/2016 12:00,559,268,291,4,20,Regen
04/03/2016 13:00,552,249,303,4,24,Regen
04/03/2016 14:00,523,232,291,2,26,Regen
04/03/2016 15:00,370,154,216,2,22,Regen
04/03/2016 16:00,396,156,240,1,15,Regen
04/03/2016 17:00,403,169,234,2,15,Regen
04/03/2016 18:00,431,182,249,3,11,wolkig
04/03/2016 19:00,335,155,180,3,11,wolkig
04/03/2016 20:00,298,144,154,3,9,wolkig
04/03/2016 21:00,185,76,109,3,7,wolkig
04/03/2016 22:00,143,70,73,3,7,wolkig
04/03/2016 23:00,125,63,62,3,7,wolkig
05/03/2016 00:00,100,47,53,3,6,wolkig
05/03/2016 01:00,120,53,67,3,2,wolkig
05/03/2016 02:00,67,29,38,2,2,Nebel
05/03/2016 03:00,45,24,21,0,2,Nebel
05/03/2016 04:00,45,33,12,2,2,Nebel
05/03/2016 05:00,30,17,13,2,6,Nebel
05/03/2016 06:00,37,19,18,2,4,Nebel
05/03/2016 07:00,120,68,52,2,4,Nebel
05/03/2016 08:00,153,85,68,2,6,wolkig
05/03/2016 09:00,317,215,102,2,11,wolkig
05/03/2016 10:00,442,291,151,3,9,wolkig
05/03/2016 11:00,488,279,209,4,7,wolkig
05/03/2016 12:00,531,278,253,5,7,wolkig
05/03/2016 13:00,558,277,281,5,6,wolkig
05/03/2016 14:00,513,239,274,5,9,wolkig
05/03/2016 15:00,441,201,240,6,7,wolkig
05/03/2016 16:00,442,200,242,5,7,wolkig
05/03/2016 17:00,446,187,259,5,6,wolkig
05/03/2016 18:00,394,171,223,4,0,Klarer Himmel
05/03/2016 19:00,269,124,145,4,2,
05/03/2016 20:00,254,122,132,3,2,
05/03/2016 21:00,192,88,104,1,4,
05/03/2016 22:00,163,98,65,0,2,Nebel
05/03/2016 23:00,164,92,72,0,0,Nebel
06/03/2016 00:00,158,78,80,-2,0,Nebel
06/03/2016 01:00,126,65,61,-2,4,Nebel
06/03/2016 02:00,81,47,34,-2,4,Nebel
06/03/2016 03:00,66,31,35,-3,2,Nebel
06/03/2016 04:00,43,21,22,-2,0,Nebel
06/03/2016 05:00,29,19,10,-3,2,Nebel
06/03/2016 06:00,31,17,14,-3,2,Nebel
06/03/2016 07:00,43,20,23,-3,4,Nebel
06/03/2016 08:00,76,42,34,-1,2,Nebel
06/03/2016 09:00,134,90,44,2,2,Nebel
06/03/2016 10:00,185,102,83,4,4,
06/03/2016 11:00,224,101,123,5,4,teilweise bewölkt
06/03/2016 12:00,258,129,129,6,7,teilweise bewölkt
06/03/2016 13:00,276,145,131,6,2,teilweise bewölkt
06/03/2016 14:00,290,160,130,6,4,teilweise bewölkt
06/03/2016 15:00,301,178,123,7,6,teilweise bewölkt
06/03/2016 16:00,303,148,155,5,7,wolkig
06/03/2016 17:00,331,172,159,3,6,wolkig
06/03/2016 18:00,318,150,168,3,7,wolkig
06/03/2016 19:00,248,134,114,3,7,wolkig
06/03/2016 20:00,171,98,73,1,4,wolkig
06/03/2016 21:00,148,93,55,1,6,wolkig
06/03/2016 22:00,143,91,52,2,9,wolkig
06/03/2016 23:00,52,28,24,2,13,Regen
07/03/2016 00:00,30,22,8,2,11,teilweise bewölkt
07/03/2016 01:00,11,6,5,1,6,teilweise bewölkt
07/03/2016 02:00,13,11,2,1,6,Nebel
07/03/2016 03:00,7,5,2,1,7,Nebel
07/03/2016 04:00,13,5,8,1,6,wolkig
07/03/2016 05:00,60,33,27,1,7,Schnee
07/03/2016 06:00,274,136,138,1,6,wolkig
07/03/2016 07:00,806,525,281,2,6,wolkig
07/03/2016 08:00,642,403,239,2,7,Regen
07/03/2016 09:00,467,323,144,2,9,wolkig
07/03/2016 10:00,432,272,160,3,6,wolkig
07/03/2016 11:00,423,248,175,3,7,wolkig
07/03/2016 12:00,516,258,258,3,9,wolkig
07/03/2016 13:00,528,246,282,4,7,wolkig
07/03/2016 14:00,538,273,265,4,6,wolkig
07/03/2016 15:00,643,313,330,5,11,teilweise bewölkt
07/03/2016 16:00,763,346,417,5,6,teilweise bewölkt
07/03/2016 17:00,868,429,439,5,6,teilweise bewölkt
07/03/2016 18:00,792,345,447,2,2,teilweise bewölkt
07/03/2016 19:00,592,263,329,0,2,Klarer Himmel
07/03/2016 20:00,329,155,174,0,4,Klarer Himmel
07/03/2016 21:00,263,108,155,-1,2,Klarer Himmel
07/03/2016 22:00,183,90,93,-2,2,Nebel
07/03/2016 23:00,76,35,41,-2,2,Nebel
08/03/2016 00:00,54,26,28,-3,0,Nebel
08/03/2016 01:00,22,11,11,-3,0,Nebel
08/03/2016 02:00,9,6,3,-3,2,Nebel
08/03/2016 03:00,4,1,3,-4,2,Nebel
08/03/2016 04:00,15,5,10,-4,4,Nebel
08/03/2016 05:00,81,42,39,-4,0,Nebel
08/03/2016 06:00,298,134,164,-4,0,Nebel
08/03/2016 07:00,846,532,314,-2,4,teilweise bewölkt
08/03/2016 08:00,731,495,236,-1,4,Nebel
08/03/2016 09:00,547,376,171,0,7,wolkig
08/03/2016 10:00,444,281,163,2,7,Regen
08/03/2016 11:00,412,217,195,4,11,wolkig
08/03/2016 12:00,535,273,262,5,17,wolkig
08/03/2016 13:00,566,272,294,5,15,teilweise bewölkt
08/03/2016 14:00,613,298,315,6,19,teilweise bewölkt
08/03/2016 15:00,729,330,399,6,20,wolkig
08/03/2016 16:00,856,378,478,5,15,wolkig
08/03/2016 17:00,883,375,508,5,11,wolkig
08/03/2016 18:00,802,372,430,4,11,
08/03/2016 19:00,628,275,353,3,9,wolkig
08/03/2016 20:00,333,148,185,3,11,wolkig
08/03/2016 21:00,230,106,124,3,13,Klarer Himmel
08/03/2016 22:00,258,156,102,2,13,Klarer Himmel
08/03/2016 23:00,104,62,42,2,11,Klarer Himmel
09/03/2016 00:00,49,26,23,1,9,Klarer Himmel
09/03/2016 01:00,24,15,9,1,9,Klarer Himmel
09/03/2016 02:00,8,6,2,0,11,Klarer Himmel
09/03/2016 03:00,14,6,8,0,11,Klarer Himmel
09/03/2016 04:00,12,3,9,0,9,Klarer Himmel
09/03/2016 05:00,83,41,42,-1,9,Klarer Himmel
09/03/2016 06:00,306,136,170,-1,9,Klarer Himmel
09/03/2016 07:00,889,580,309,0,7,Klarer Himmel
09/03/2016 08:00,804,530,274,1,15,Klarer Himmel
09/03/2016 09:00,568,393,175,3,15,Klarer Himmel
09/03/2016 10:00,505,335,170,5,24,Klarer Himmel
09/03/2016 11:00,503,302,201,6,22,Klarer Himmel
09/03/2016 12:00,636,319,317,7,22,Klarer Himmel
09/03/2016 13:00,663,320,343,7,24,Klarer Himmel
09/03/2016 14:00,652,292,360,7,20,Klarer Himmel
09/03/2016 15:00,668,291,377,7,22,Klarer Himmel
09/03/2016 16:00,826,368,458,8,15,Klarer Himmel
09/03/2016 17:00,935,430,505,7,11,Klarer Himmel
09/03/2016 18:00,841,373,468,7,9,Klarer Himmel
09/03/2016 19:00,626,280,346,6,7,Klarer Himmel
09/03/2016 20:00,372,174,198,5,4,Klarer Himmel
09/03/2016 21:00,268,119,149,4,6,Klarer Himmel
09/03/2016 22:00,273,128,145,4,6,Klarer Himmel
09/03/2016 23:00,130,69,61,3,6,Klarer Himmel
10/03/2016 00:00,86,51,35,2,6,Klarer Himmel
10/03/2016 01:00,40,10,30,3,7,Klarer Himmel
10/03/2016 02:00,25,8,17,3,6,Klarer Himmel
10/03/2016 03:00,22,16,6,0,9,Klarer Himmel
10/03/2016 04:00,16,8,8,1,9,
10/03/2016 05:00,85,40,45,0,9,
10/03/2016 06:00,299,139,160,-1,7,
10/03/2016 07:00,832,529,303,0,7,
10/03/2016 08:00,711,497,214,2,11,
10/03/2016 09:00,541,374,167,3,17,
10/03/2016 10:00,430,245,185,5,13,Klarer Himmel
10/03/2016 11:00,500,286,214,6,13,wolkig
10/03/2016 12:00,562,302,260,6,15,wolkig
10/03/2016 13:00,651,309,342,7,13,wolkig
10/03/2016 14:00,599,276,323,6,15,wolkig
10/03/2016 15:00,718,331,387,7,13,wolkig
10/03/2016 16:00,863,366,497,7,11,wolkig
10/03/2016 17:00,887,429,458,7,7,wolkig
10/03/2016 18:00,773,352,421,6,9,wolkig
10/03/2016 19:00,570,247,323,5,9,wolkig
10/03/2016 20:00,345,157,188,5,6,wolkig
10/03/2016 21:00,248,118,130,5,4,wolkig
10/03/2016 22:00,264,145,119,6,9,wolkig
10/03/2016 23:00,138,61,77,5,11,wolkig
11/03/2016 00:00,50,27,23,4,9,wolkig
11/03/2016 01:00,22,6,16,2,9,teilweise bewölkt
11/03/2016 02:00,16,7,9,1,6,Nebel
11/03/2016 03:00,15,4,11,1,7,Nebel
11/03/2016 04:00,10,5,5,2,6,wolkig
11/03/2016 05:00,65,36,29,3,9,wolkig
11/03/2016 06:00,294,142,152,3,9,wolkig
11/03/2016 07:00,824,536,288,3,6,wolkig
11/03/2016 08:00,667,471,196,4,9,wolkig
11/03/2016 09:00,500,337,163,3,15,wolkig
11/03/2016 10:00,410,262,148,3,11,wolkig
11/03/2016 11:00,520,276,244,4,15,wolkig
11/03/2016 12:00,608,291,317,4,13,wolkig
11/03/2016 13:00,702,322,380,4,11,wolkig
11/03/2016 14:00,720,354,366,4,11,wolkig
11/03/2016 15:00,735,349,386,4,11,wolkig
11/03/2016 16:00,691,322,369,5,15,wolkig
11/03/2016 17:00,716,321,395,4,11,wolkig
11/03/2016 18:00,632,270,362,3,9,teilweise bewölkt
11/03/2016 19:00,542,257,285,2,6,Klarer Himmel
11/03/2016 20:00,362,180,182,2,7,Klarer Himmel
11/03/2016 21:00,265,118,147,2,4,teilweise bewölkt
11/03/2016 22:00,229,119,110,1,4,Klarer Himmel
11/03/2016 23:00,162,76,86,-1,4,Klarer Himmel
12/03/2016 00:00,168,81,87,0,4,Klarer Himmel
12/03/2016 01:00,129,60,69,-1,6,
12/03/2016 02:00,76,41,35,0,6,
12/03/2016 03:00,54,39,15,0,4,
12/03/2016 04:00,39,24,15,-2,6,
12/03/2016 05:00,52,36,16,-2,2,Nebel
12/03/2016 06:00,57,29,28,-2,2,Nebel
12/03/2016 07:00,123,55,68,-2,4,Nebel
12/03/2016 08:00,233,145,88,2,6,wolkig
12/03/2016 09:00,413,279,134,4,11,wolkig
12/03/2016 10:00,497,334,163,4,6,wolkig
12/03/2016 11:00,549,330,219,4,7,wolkig
12/03/2016 12:00,606,330,276,5,9,wolkig
12/03/2016 13:00,602,319,283,5,11,wolkig
12/03/2016 14:00,585,265,320,6,11,wolkig
12/03/2016 15:00,509,221,288,6,7,wolkig
12/03/2016 16:00,468,186,282,5,13,teilweise bewölkt
12/03/2016 17:00,454,183,271,5,11,teilweise bewölkt
12/03/2016 18:00,426,168,258,4,9,teilweise bewölkt
12/03/2016 19:00,401,185,216,3,7,teilweise bewölkt
12/03/2016 20:00,281,148,133,2,7,Klarer Himmel
12/03/2016 21:00,197,98,99,1,7,wolkig
12/03/2016 22:00,226,115,111,2,7,teilweise bewölkt
12/03/2016 23:00,176,87,89,2,9,teilweise bewölkt
13/03/2016 00:00,160,67,93,2,6,wolkig
13/03/2016 01:00,137,69,68,2,7,wolkig
13/03/2016 02:00,116,56,60,3,7,wolkig
13/03/2016 03:00,62,36,26,3,6,wolkig
13/03/2016 04:00,63,43,20,3,6,wolkig
13/03/2016 05:00,42,32,10,3,9,wolkig
13/03/2016 06:00,37,17,20,3,9,wolkig
13/03/2016 07:00,47,22,25,3,13,wolkig
13/03/2016 08:00,87,50,37,4,17,wolkig
13/03/2016 09:00,145,77,68,4,13,wolkig
13/03/2016 10:00,204,117,87,4,11,wolkig
13/03/2016 11:00,190,102,88,4,13,wolkig
13/03/2016 12:00,256,123,133,5,13,wolkig
13/03/2016 13:00,298,159,139,5,24,teilweise bewölkt
13/03/2016 14:00,346,185,161,5,19,wolkig
13/03/2016 15:00,334,209,125,5,11,teilweise bewölkt
13/03/2016 16:00,338,180,158,6,13,Klarer Himmel
13/03/2016 17:00,348,151,197,6,9,Klarer Himmel
13/03/2016 18:00,316,168,148,4,6,teilweise bewölkt
13/03/2016 19:00,240,137,103,4,15,teilweise bewölkt
13/03/2016 20:00,190,96,94,2,15,teilweise bewölkt
13/03/2016 21:00,139,86,53,2,11,wolkig
13/03/2016 22:00,111,70,41,2,17,wolkig
13/03/2016 23:00,56,31,25,1,17,wolkig
14/03/2016 00:00,31,25,6,1,7,wolkig
14/03/2016 01:00,10,7,3,1,6,wolkig
14/03/2016 02:00,2,1,1,0,6,Klarer Himmel
14/03/2016 03:00,6,2,4,-1,6,Klarer Himmel
14/03/2016 04:00,11,8,3,-1,6,Klarer Himmel
14/03/2016 05:00,65,28,37,-1,7,
14/03/2016 06:00,303,142,161,-1,7,
14/03/2016 07:00,828,564,264,-1,9,
14/03/2016 08:00,750,507,243,1,7,Klarer Himmel
14/03/2016 09:00,561,392,169,3,11,Klarer Himmel
14/03/2016 10:00,459,300,159,4,13,Klarer Himmel
14/03/2016 11:00,495,288,207,6,11,Klarer Himmel
14/03/2016 12:00,525,267,258,7,15,Klarer Himmel
14/03/2016 13:00,625,311,314,8,17,Klarer Himmel
14/03/2016 14:00,602,318,284,9,17,Klarer Himmel
14/03/2016 15:00,678,315,363,9,20,Klarer Himmel
14/03/2016 16:00,874,393,481,9,20,Klarer Himmel
14/03/2016 17:00,911,412,499,8,15,Klarer Himmel
14/03/2016 18:00,749,305,444,6,13,Klarer Himmel
14/03/2016 19:00,585,234,351,5,7,Klarer Himmel
14/03/2016 20:00,332,140,192,4,2,Klarer Himmel
14/03/2016 21:00,261,127,134,3,0,Klarer Himmel
14/03/2016 22:00,177,88,89,1,2,Klarer Himmel
14/03/2016 23:00,111,59,52,1,4,Klarer Himmel
15/03/2016 00:00,47,26,21,0,2,Klarer Himmel
15/03/2016 01:00,27,12,15,1,4,Klarer Himmel
15/03/2016 02:00,8,4,4,-1,4,
15/03/2016 03:00,9,4,5,-1,2,wolkig
15/03/2016 04:00,13,10,3,-1,7,wolkig
15/03/2016 05:00,77,39,38,2,4,wolkig
15/03/2016 06:00,319,142,177,2,4,Nebel
15/03/2016 07:00,843,543,300,2,2,Regen
15/03/2016 08:00,766,527,239,4,6,Regen
15/03/2016 09:00,546,374,172,4,13,wolkig
15/03/2016 10:00,471,309,162,5,11,wolkig
15/03/2016 11:00,441,257,184,6,11,wolkig
15/03/2016 12:00,500,245,255,6,11,wolkig
15/03/2016 13:00,571,271,300,6,11,wolkig
15/03/2016 14:00,603,294,309,7,15,wolkig
15/03/2016 15:00,683,324,359,8,19,wolkig
15/03/2016 16:00,802,353,449,7,13,Regen
15/03/2016 17:00,916,413,503,7,15,wolkig
15/03/2016 18:00,847,373,474,7,17,teilweise bewölkt
15/03/2016 19:00,593,252,341,5,17,teilweise bewölkt
15/03/2016 20:00,381,147,234,5,13,teilweise bewölkt
15/03/2016 21:00,252,118,134,5,17,Klarer Himmel
15/03/2016 22:00,219,119,100,4,11,Klarer Himmel
15/03/2016 23:00,99,51,48,3,11,Klarer Himmel
16/03/2016 00:00,47,24,23,2,9,Klarer Himmel
16/03/2016 01:00,22,16,6,1,7,Klarer Himmel
16/03/2016 02:00,12,5,7,2,9,wolkig
16/03/2016 03:00,12,7,5,3,11,wolkig
16/03/2016 04:00,14,8,6,3,15,wolkig
16/03/2016 05:00,74,39,35,3,11,wolkig
16/03/2016 06:00,322,140,182,3,17,wolkig
16/03/2016 07:00,861,548,313,3,13,wolkig
16/03/2016 08:00,789,529,260,4,20,teilweise bewölkt
16/03/2016 09:00,579,422,157,5,15,teilweise bewölkt
16/03/2016 10:00,569,344,225,6,15,wolkig
16/03/2016 11:00,523,296,227,6,19,wolkig
16/03/2016 12:00,626,322,304,7,19,wolkig
16/03/2016 13:00,654,315,339,7,19,wolkig
16/03/2016 14:00,610,272,338,8,19,teilweise bewölkt
16/03/2016 15:00,650,299,351,8,22,teilweise bewölkt
16/03/2016 16:00,807,325,482,8,17,teilweise bewölkt
16/03/2016 17:00,908,441,467,8,15,teilweise bewölkt
16/03/2016 18:00,805,350,455,6,9,teilweise bewölkt
16/03/2016 19:00,625,275,350,6,6,Klarer Himmel
16/03/2016 20:00,381,177,204,6,7,Klarer Himmel
16/03/2016 21:00,276,128,148,5,7,Klarer Himmel
16/03/2016 22:00,217,107,110,4,7,Klarer Himmel
16/03/2016 23:00,185,88,97,3,4,Klarer Himmel
17/03/2016 00:00,82,42,40,2,6,Klarer Himmel
17/03/2016 01:00,41,14,27,1,2,Klarer Himmel
17/03/2016 02:00,34,16,18,2,6,Klarer Himmel
17/03/2016 03:00,25,10,15,1,7,Klarer Himmel
17/03/2016 04:00,27,15,12,0,4,Klarer Himmel
17/03/2016 05:00,71,38,33,0,6,Klarer Himmel
17/03/2016 06:00,296,128,168,0,7,Klarer Himmel
17/03/2016 07:00,797,491,306,1,6,Klarer Himmel
17/03/2016 08:00,839,592,247,4,9,Klarer Himmel
17/03/2016 09:00,594,403,191,7,13,Klarer Himmel
17/03/2016 10:00,487,326,161,9,15,Klarer Himmel
17/03/2016 11:00,462,278,184,10,17,Klarer Himmel
17/03/2016 12:00,560,295,265,10,11,Klarer Himmel
17/03/2016 13:00,683,340,343,11,15,Klarer Himmel
17/03/2016 14:00,672,324,348,11,15,Klarer Himmel
17/03/2016 15:00,800,364,436,12,11,Klarer Himmel
17/03/2016 16:00,909,426,483,12,11,Klarer Himmel
17/03/2016 17:00,976,460,516,11,11,Klarer Himmel
17/03/2016 18:00,860,348,512,8,6,Klarer Himmel
17/03/2016 19:00,639,310,329,6,2,Klarer Himmel
17/03/2016 20:00,389,182,207,3,2,Klarer Himmel
17/03/2016 21:00,273,131,142,3,2,Klarer Himmel
17/03/2016 22:00,268,123,145,1,6,Klarer Himmel
17/03/2016 23:00,155,79,76,2,2,Klarer Himmel
18/03/2016 00:00,66,32,34,1,6,
18/03/2016 01:00,44,17,27,1,6,
18/03/2016 02:00,37,9,28,1,13,Nebel
18/03/2016 03:00,8,4,4,1,11,Nebel
18/03/2016 04:00,22,8,14,1,7,wolkig
18/03/2016 05:00,77,44,33,1,13,wolkig
18/03/2016 06:00,256,122,134,1,7,wolkig
18/03/2016 07:00,743,468,275,2,11,Regen
18/03/2016 08:00,715,488,227,3,11,Regen
18/03/2016 09:00,499,351,148,4,13,wolkig
18/03/2016 10:00,423,245,178,4,13,Regen
18/03/2016 11:00,519,292,227,5,11,wolkig
18/03/2016 12:00,639,288,351,5,13,wolkig
18/03/2016 13:00,708,315,393,6,13,wolkig
18/03/2016 14:00,652,288,364,6,15,wolkig
18/03/2016 15:00,693,315,378,6,13,wolkig
18/03/2016 16:00,746,345,401,6,15,wolkig
18/03/2016 17:00,735,345,390,6,13,wolkig
18/03/2016 18:00,635,256,379,5,9,wolkig
18/03/2016 19:00,452,183,269,5,11,Regen
18/03/2016 20:00,375,180,195,5,9,wolkig
18/03/2016 21:00,248,123,125,5,6,wolkig
18/03/2016 22:00,223,103,120,5,7,wolkig
18/03/2016 23:00,184,88,96,5,7,wolkig
19/03/2016 00:00,124,57,67,5,9,wolkig
19/03/2016 01:00,114,51,63,5,6,wolkig
19/03/2016 02:00,58,30,28,5,7,wolkig
19/03/2016 03:00,41,23,18,5,9,wolkig
19/03/2016 04:00,42,31,11,5,2,wolkig
19/03/2016 05:00,59,40,19,5,6,wolkig
19/03/2016 06:00,58,32,26,5,7,wolkig
19/03/2016 07:00,113,72,41,5,7,wolkig
19/03/2016 08:00,206,130,76,5,9,wolkig
19/03/2016 09:00,348,244,104,5,9,wolkig
19/03/2016 10:00,487,323,164,5,9,wolkig
19/03/2016 11:00,589,369,220,5,9,wolkig
19/03/2016 12:00,568,294,274,5,13,wolkig
19/03/2016 13:00,567,291,276,5,7,wolkig
19/03/2016 14:00,556,229,327,6,7,wolkig
19/03/2016 15:00,525,247,278,6,9,wolkig
19/03/2016 16:00,445,182,263,7,9,wolkig
19/03/2016 17:00,435,186,249,7,7,wolkig
19/03/2016 18:00,408,174,234,6,11,wolkig
19/03/2016 19:00,343,162,181,6,9,wolkig
19/03/2016 20:00,238,110,128,6,11,wolkig
19/03/2016 21:00,182,86,96,6,11,wolkig
19/03/2016 22:00,166,84,82,5,7,wolkig
19/03/2016 23:00,129,58,71,5,7,wolkig
20/03/2016 00:00,168,64,104,5,9,wolkig
20/03/2016 01:00,171,75,96,5,11,Regen
20/03/2016 02:00,87,51,36,5,11,Regen
20/03/2016 03:00,62,31,31,4,11,Regen
20/03/2016 04:00,62,45,17,4,11,Regen
20/03/2016 05:00,43,31,12,4,9,Regen
20/03/2016 06:00,23,15,8,4,9,wolkig
20/03/2016 07:00,41,17,24,4,13,wolkig
20/03/2016 08:00,61,33,28,5,13,wolkig
20/03/2016 09:00,113,61,52,6,13,wolkig
20/03/2016 10:00,192,118,74,6,15,Regen
20/03/2016 11:00,215,117,98,7,20,wolkig
20/03/2016 12:00,273,138,135,7,19,Regen
20/03/2016 13:00,313,151,162,7,19,wolkig
20/03/2016 14:00,330,167,163,7,17,Regen
20/03/2016 15:00,334,180,154,7,17,Regen
20/03/2016 16:00,292,145,147,7,17,Regen
20/03/2016 17:00,306,159,147,7,11,wolkig
20/03/2016 18:00,268,146,122,7,13,wolkig
20/03/2016 19:00,221,91,130,7,9,wolkig
20/03/2016 20:00,176,95,81,7,9,wolkig
20/03/2016 21:00,116,67,49,7,9,wolkig
20/03/2016 22:00,116,77,39,7,9,wolkig
20/03/2016 23:00,89,63,26,6,15,wolkig
21/03/2016 00:00,31,15,16,6,13,Regen
21/03/2016 01:00,10,8,2,6,13,wolkig
21/03/2016 02:00,2,2,0,6,11,Regen
21/03/2016 03:00,5,3,2,6,13,wolkig
21/03/2016 04:00,16,7,9,6,11,wolkig
21/03/2016 05:00,62,33,29,5,9,Regen
21/03/2016 06:00,214,112,102,5,7,Regen
21/03/2016 07:00,505,328,177,6,15,Regen
21/03/2016 08:00,597,393,204,6,13,Regen
21/03/2016 09:00,457,334,123,7,19,wolkig
21/03/2016 10:00,394,258,136,7,13,wolkig
21/03/2016 11:00,429,258,171,9,19,wolkig
21/03/2016 12:00,469,245,224,9,19,wolkig
21/03/2016 13:00,475,233,242,9,20,wolkig
21/03/2016 14:00,510,247,263,8,22,wolkig
21/03/2016 15:00,598,301,297,8,24,wolkig
21/03/2016 16:00,726,290,436,8,22,wolkig
21/03/2016 17:00,796,366,430,8,20,wolkig
21/03/2016 18:00,677,285,392,7,9,wolkig
21/03/2016 19:00,487,207,280,7,20,Regen
21/03/2016 20:00,273,124,149,6,11,wolkig
21/03/2016 21:00,219,103,116,6,15,wolkig
21/03/2016 22:00,169,79,90,6,17,wolkig
21/03/2016 23:00,87,34,53,6,13,wolkig
22/03/2016 00:00,59,26,33,6,13,wolkig
22/03/2016 01:00,19,11,8,6,15,wolkig
22/03/2016 02:00,8,6,2,6,13,Regen
22/03/2016 03:00,9,5,4,5,13,wolkig
22/03/2016 04:00,9,4,5,5,15,wolkig
22/03/2016 05:00,72,36,36,5,13,wolkig
22/03/2016 06:00,237,128,109,6,11,Regen
22/03/2016 07:00,516,310,206,6,13,Regen
22/03/2016 08:00,630,454,176,6,15,wolkig
22/03/2016 09:00,481,350,131,7,13,wolkig
22/03/2016 10:00,388,237,151,8,15,wolkig
22/03/2016 11:00,434,252,182,8,17,Regen
22/03/2016 12:00,426,227,199,8,11,Regen
22/03/2016 13:00,488,261,227,8,13,Regen
22/03/2016 14:00,493,248,245,9,7,Regen
22/03/2016 15:00,518,217,301,8,9,Regen
22/03/2016 16:00,676,280,396,8,9,Regen
22/03/2016 17:00,765,346,419,8,13,Regen
22/03/2016 18:00,683,267,416,7,17,Regen
22/03/2016 19:00,551,208,343,7,11,Regen
22/03/2016 20:00,257,117,140,7,11,Regen
22/03/2016 21:00,192,91,101,7,6,Regen
22/03/2016 22:00,172,101,71,7,9,Regen
22/03/2016 23:00,106,56,50,7,13,Regen
23/03/2016 00:00,65,28,37,6,13,Regen
23/03/2016 01:00,22,14,8,7,11,wolkig
23/03/2016 02:00,16,6,10,6,9,Regen
23/03/2016 03:00,21,11,10,6,13,Regen
23/03/2016 04:00,11,6,5,6,7,Regen
23/03/2016 05:00,65,33,32,6,9,wolkig
23/03/2016 06:00,234,123,111,6,11,Regen
23/03/2016 07:00,482,304,178,6,11,wolkig
23/03/2016 08:00,647,457,190,6,11,Regen
23/03/2016 09:00,538,392,146,7,13,wolkig
23/03/2016 10:00,478,298,180,7,11,wolkig
23/03/2016 11:00,517,314,203,8,20,wolkig
23/03/2016 12:00,555,292,263,8,13,teilweise bewölkt
23/03/2016 13:00,574,288,286,8,15,wolkig
23/03/2016 14:00,534,243,291,9,20,wolkig
23/03/2016 15:00,595,272,323,9,13,wolkig
23/03/2016 16:00,685,305,380,9,19,wolkig
23/03/2016 17:00,776,341,435,8,15,
23/03/2016 18:00,684,270,414,8,11,wolkig
23/03/2016 19:00,520,236,284,7,7,wolkig
23/03/2016 20:00,339,155,184,6,13,wolkig
23/03/2016 21:00,228,102,126,5,7,teilweise bewölkt
23/03/2016 22:00,182,100,82,5,7,wolkig
23/03/2016 23:00,159,81,78,4,6,wolkig
24/03/2016 00:00,89,45,44,3,4,wolkig
24/03/2016 01:00,61,32,29,3,6,wolkig
24/03/2016 02:00,67,18,49,3,6,wolkig
24/03/2016 03:00,30,20,10,3,7,wolkig
24/03/2016 04:00,25,11,14,2,6,wolkig
24/03/2016 05:00,72,29,43,1,2,wolkig
24/03/2016 06:00,204,115,89,2,0,wolkig
24/03/2016 07:00,465,285,180,4,4,wolkig
24/03/2016 08:00,497,353,144,5,6,wolkig
24/03/2016 09:00,427,299,128,5,7,wolkig
24/03/2016 10:00,389,242,147,6,6,wolkig
24/03/2016 11:00,434,266,168,6,9,Regen
24/03/2016 12:00,477,230,247,7,9,Regen
24/03/2016 13:00,523,261,262,8,15,wolkig
24/03/2016 14:00,529,225,304,8,13,wolkig
24/03/2016 15:00,612,262,350,8,13,wolkig
24/03/2016 16:00,721,303,418,8,9,
24/03/2016 17:00,755,357,398,8,7,wolkig
24/03/2016 18:00,605,273,332,8,13,wolkig
24/03/2016 19:00,474,201,273,8,11,Regen
24/03/2016 20:00,289,127,162,8,13,Regen
24/03/2016 21:00,187,89,98,7,11,Regen
24/03/2016 22:00,173,81,92,7,11,Regen
24/03/2016 23:00,97,55,42,6,9,Regen
25/03/2016 00:00,91,44,47,6,11,Regen
25/03/2016 01:00,75,38,37,6,9,Regen
25/03/2016 02:00,34,18,16,6,9,Regen
25/03/2016 03:00,29,11,18,6,15,Regen
25/03/2016 04:00,11,7,4,6,15,Regen
25/03/2016 05:00,18,12,6,6,15,Regen
25/03/2016 06:00,28,10,18,6,17,Regen
25/03/2016 07:00,29,13,16,6,15,Regen
25/03/2016 08:00,60,26,34,7,17,Regen
25/03/2016 09:00,83,42,41,7,17,Regen
25/03/2016 10:00,92,33,59,7,17,Regen
25/03/2016 11:00,94,47,47,7,19,Regen
25/03/2016 12:00,101,46,55,8,15,Regen
25/03/2016 13:00,81,44,37,8,13,Regen
25/03/2016 14:00,137,66,71,8,13,Regen
25/03/2016 15:00,100,39,61,8,13,Regen
25/03/2016 16:00,136,73,63,8,11,wolkig
25/03/2016 17:00,153,85,68,8,9,wolkig
25/03/2016 18:00,170,90,80,8,6,wolkig
25/03/2016 19:00,145,75,70,7,6,wolkig
25/03/2016 20:00,92,39,53,6,9,wolkig
25/03/2016 21:00,81,40,41,6,9,wolkig
25/03/2016 22:00,67,35,32,7,11,wolkig
25/03/2016 23:00,54,26,28,7,17,wolkig
26/03/2016 00:00,53,31,22,7,6,wolkig
26/03/2016 01:00,32,16,16,6,7,wolkig
26/03/2016 02:00,19,9,10,6,2,wolkig
26/03/2016 03:00,11,6,5,4,2,Nebel
26/03/2016 04:00,6,4,2,3,7,Nebel
26/03/2016 05:00,20,15,5,1,6,Nebel
26/03/2016 06:00,46,23,23,3,9,Nebel
26/03/2016 07:00,101,60,41,5,7,Nebel
26/03/2016 08:00,177,113,64,7,13,teilweise bewölkt
26/03/2016 09:00,428,306,122,9,13,teilweise bewölkt
26/03/2016 10:00,606,437,169,10,19,teilweise bewölkt
26/03/2016 11:00,729,443,286,12,20,teilweise bewölkt
26/03/2016 12:00,780,417,363,13,24,teilweise bewölkt
26/03/2016 13:00,681,340,341,14,19,Klarer Himmel
26/03/2016 14:00,610,269,341,14,20,wolkig
26/03/2016 15:00,526,209,317,15,22,Klarer Himmel
26/03/2016 16:00,487,209,278,15,32,Klarer Himmel
26/03/2016 17:00,447,160,287,14,22,Klarer Himmel
26/03/2016 18:00,348,133,215,13,17,Klarer Himmel
26/03/2016 19:00,260,111,149,12,17,Klarer Himmel
26/03/2016 20:00,203,91,112,12,19,Klarer Himmel
26/03/2016 21:00,122,60,62,11,19,Klarer Himmel
26/03/2016 22:00,141,80,61,10,15,Klarer Himmel
26/03/2016 23:00,107,41,66,10,20,Klarer Himmel
27/03/2016 00:00,118,41,77,9,13,Klarer Himmel
27/03/2016 01:00,94,44,50,9,9,Klarer Himmel
27/03/2016 03:00,0,0,0,,,
27/03/2016 03:00,73,34,39,9,9,Klarer Himmel
27/03/2016 04:00,58,31,27,10,17,Klarer Himmel
27/03/2016 05:00,44,33,11,10,15,Klarer Himmel
27/03/2016 06:00,33,22,11,10,7,Regen
27/03/2016 07:00,36,17,19,9,9,wolkig
27/03/2016 08:00,39,11,28,9,28,Regen
27/03/2016 09:00,50,24,26,8,19,Regen
27/03/2016 10:00,76,40,36,8,24,Regen
27/03/2016 11:00,59,19,40,8,19,wolkig
27/03/2016 12:00,102,47,55,9,24,wolkig
27/03/2016 13:00,126,60,66,10,20,wolkig
27/03/2016 14:00,115,51,64,11,32,teilweise bewölkt
27/03/2016 15:00,176,91,85,12,28,wolkig
27/03/2016 16:00,175,89,86,12,19,Regen
27/03/2016 17:00,143,72,71,12,24,wolkig
27/03/2016 18:00,150,73,77,12,19,teilweise bewölkt
27/03/2016 19:00,156,89,67,11,13,Klarer Himmel
27/03/2016 20:00,131,71,60,10,15,Klarer Himmel
27/03/2016 21:00,111,62,49,9,19,Klarer Himmel
27/03/2016 22:00,81,48,33,9,19,Klarer Himmel
27/03/2016 23:00,66,42,24,8,15,teilweise bewölkt
28/03/2016 00:00,55,25,30,8,17,Klarer Himmel
28/03/2016 01:00,66,16,50,7,13,Klarer Himmel
28/03/2016 02:00,25,11,14,8,17,Klarer Himmel
28/03/2016 03:00,33,12,21,8,19,Klarer Himmel
28/03/2016 04:00,31,25,6,7,19,Klarer Himmel
28/03/2016 05:00,29,25,4,8,20,Klarer Himmel
28/03/2016 06:00,21,10,11,8,24,Klarer Himmel
28/03/2016 07:00,31,15,16,8,20,Klarer Himmel
28/03/2016 08:00,45,23,22,9,28,Klarer Himmel
28/03/2016 09:00,65,36,29,9,43,Regen
28/03/2016 10:00,93,47,46,10,28,Regen
28/03/2016 11:00,128,63,65,11,35,wolkig
28/03/2016 12:00,124,67,57,12,37,wolkig
28/03/2016 13:00,143,74,69,12,37,wolkig
28/03/2016 14:00,160,87,73,11,32,Regen
28/03/2016 15:00,122,62,60,9,19,wolkig
28/03/2016 16:00,164,93,71,10,15,wolkig
28/03/2016 17:00,159,108,51,10,24,teilweise bewölkt
28/03/2016 18:00,162,90,72,10,19,teilweise bewölkt
28/03/2016 19:00,177,95,82,10,19,teilweise bewölkt
28/03/2016 20:00,168,89,79,9,15,wolkig
28/03/2016 21:00,106,63,43,9,15,teilweise bewölkt
28/03/2016 22:00,84,41,43,8,17,teilweise bewölkt
28/03/2016 23:00,51,33,18,8,11,wolkig
29/03/2016 00:00,34,24,10,8,19,wolkig
29/03/2016 01:00,18,9,9,7,26,Regen
29/03/2016 02:00,13,6,7,7,15,Regen
29/03/2016 03:00,5,0,5,6,22,wolkig
29/03/2016 04:00,20,8,12,6,22,wolkig
29/03/2016 05:00,61,29,32,6,24,wolkig
29/03/2016 06:00,178,90,88,6,24,wolkig
29/03/2016 07:00,460,298,162,6,24,Regen
29/03/2016 08:00,477,320,157,7,26,wolkig
29/03/2016 09:00,383,274,109,7,24,wolkig
29/03/2016 10:00,361,220,141,7,28,wolkig
29/03/2016 11:00,423,260,163,8,28,Regen
29/03/2016 12:00,405,211,194,8,20,wolkig
29/03/2016 13:00,392,190,202,9,26,wolkig
29/03/2016 14:00,462,254,208,10,28,wolkig
29/03/2016 15:00,581,291,290,11,37,wolkig
29/03/2016 16:00,672,302,370,9,26,Regen
29/03/2016 17:00,791,364,427,10,26,wolkig
29/03/2016 18:00,683,288,395,10,26,wolkig
29/03/2016 19:00,495,210,285,9,20,teilweise bewölkt
29/03/2016 20:00,330,141,189,8,11,teilweise bewölkt
29/03/2016 21:00,187,95,92,7,7,teilweise bewölkt
29/03/2016 22:00,193,105,88,5,7,Klarer Himmel
29/03/2016 23:00,119,70,49,6,9,Klarer Himmel
30/03/2016 00:00,66,33,33,6,9,Klarer Himmel
30/03/2016 01:00,37,13,24,6,11,Klarer Himmel
30/03/2016 02:00,9,5,4,7,15,Regen
30/03/2016 03:00,11,8,3,7,17,Regen
30/03/2016 04:00,9,4,5,8,17,wolkig
30/03/2016 05:00,63,32,31,9,15,wolkig
30/03/2016 06:00,200,105,95,9,22,wolkig
30/03/2016 07:00,470,289,181,7,24,wolkig
30/03/2016 08:00,551,375,176,8,22,wolkig
30/03/2016 09:00,514,367,147,8,26,wolkig
30/03/2016 10:00,466,299,167,9,28,wolkig
30/03/2016 11:00,539,340,199,10,28,wolkig
30/03/2016 12:00,538,296,242,11,28,wolkig
30/03/2016 13:00,579,285,294,11,32,wolkig
30/03/2016 14:00,581,288,293,11,28,wolkig
30/03/2016 15:00,642,272,370,12,30,wolkig
30/03/2016 16:00,708,294,414,12,32,wolkig
30/03/2016 17:00,813,361,452,12,30,wolkig
30/03/2016 18:00,764,318,446,11,22,wolkig
30/03/2016 19:00,577,277,300,10,20,wolkig
30/03/2016 20:00,345,159,186,9,9,wolkig
30/03/2016 21:00,238,100,138,8,7,wolkig
30/03/2016 22:00,205,109,96,8,6,Klarer Himmel
30/03/2016 23:00,158,72,86,7,4,wolkig
31/03/2016 00:00,93,48,45,6,2,Klarer Himmel
31/03/2016 01:00,83,35,48,5,2,Klarer Himmel
31/03/2016 02:00,44,26,18,5,2,Klarer Himmel
31/03/2016 03:00,33,15,18,5,2,Klarer Himmel
31/03/2016 04:00,26,16,10,5,0,Klarer Himmel
31/03/2016 05:00,80,38,42,4,2,Klarer Himmel
31/03/2016 06:00,214,110,104,4,2,Klarer Himmel
31/03/2016 07:00,515,316,199,4,4,wolkig
31/03/2016 08:00,569,376,193,6,2,Klarer Himmel
31/03/2016 09:00,491,339,152,7,4,wolkig
31/03/2016 10:00,423,255,168,8,4,wolkig
31/03/2016 11:00,465,279,186,9,11,wolkig
31/03/2016 12:00,496,269,227,10,11,wolkig
31/03/2016 13:00,538,259,279,10,19,wolkig
31/03/2016 14:00,596,296,300,10,17,wolkig
31/03/2016 15:00,650,305,345,11,17,wolkig
31/03/2016 16:00,733,286,447,10,17,wolkig
31/03/2016 17:00,796,392,404,10,17,wolkig
31/03/2016 18:00,758,327,431,9,17,wolkig
31/03/2016 19:00,616,253,363,9,15,wolkig
31/03/2016 20:00,344,156,188,8,9,wolkig
31/03/2016 21:00,207,107,100,8,17,wolkig
31/03/2016 22:00,229,115,114,7,17,Klarer Himmel
31/03/2016 23:00,130,77,53,7,17,Klarer Himmel
01/04/2016 00:00,71,42,29,6,20,Klarer Himmel
01/04/2016 01:00,39,21,18,6,19,Klarer Himmel
01/04/2016 02:00,17,11,6,6,11,Klarer Himmel
01/04/2016 03:00,17,5,12,5,9,Klarer Himmel
01/04/2016 04:00,16,6,10,5,13,Klarer Himmel
01/04/2016 05:00,72,38,34,3,9,teilweise bewölkt
01/04/2016 06:00,206,104,102,2,6,Klarer Himmel
01/04/2016 07:00,476,299,177,2,4,Klarer Himmel
01/04/2016 08:00,583,404,179,5,9,Klarer Himmel
01/04/2016 09:00,457,314,143,6,9,Klarer Himmel
01/04/2016 10:00,486,318,168,8,6,Klarer Himmel
01/04/2016 11:00,531,318,213,9,6,teilweise bewölkt
01/04/2016 12:00,628,300,328,11,7,teilweise bewölkt
01/04/2016 13:00,671,329,342,12,9,teilweise bewölkt
01/04/2016 14:00,744,361,383,13,9,teilweise bewölkt
01/04/2016 15:00,691,355,336,13,9,teilweise bewölkt
01/04/2016 16:00,775,354,421,14,6,Klarer Himmel
01/04/2016 17:00,761,319,442,13,13,Klarer Himmel
01/04/2016 18:00,695,306,389,12,6,Klarer Himmel
01/04/2016 19:00,574,246,328,11,4,Klarer Himmel
01/04/2016 20:00,420,197,223,10,6,Klarer Himmel
01/04/2016 21:00,302,134,168,9,6,Klarer Himmel
01/04/2016 22:00,264,136,128,8,6,Klarer Himmel
01/04/2016 23:00,167,76,91,8,6,Klarer Himmel
02/04/2016 00:00,183,85,98,7,6,Klarer Himmel
02/04/2016 01:00,149,72,77,6,4,Klarer Himmel
02/04/2016 02:00,95,41,54,6,6,Klarer Himmel
02/04/2016 03:00,61,43,18,5,6,Klarer Himmel
02/04/2016 04:00,52,31,21,5,6,Klarer Himmel
02/04/2016 05:00,67,46,21,5,7,Klarer Himmel
02/04/2016 06:00,63,36,27,4,6,Klarer Himmel
02/04/2016 07:00,128,70,58,4,6,Klarer Himmel
02/04/2016 08:00,208,125,83,6,7,Klarer Himmel
02/04/2016 09:00,404,286,118,8,13,Klarer Himmel
02/04/2016 10:00,604,390,214,10,9,Klarer Himmel
02/04/2016 11:00,741,472,269,11,9,Klarer Himmel
02/04/2016 12:00,807,447,360,13,11,Klarer Himmel
02/04/2016 13:00,784,384,400,14,11,teilweise bewölkt
02/04/2016 14:00,757,331,426,14,13,teilweise bewölkt
02/04/2016 15:00,665,287,378,14,13,Klarer Himmel
02/04/2016 16:00,551,219,332,15,9,Klarer Himmel
02/04/2016 17:00,611,252,359,15,7,Klarer Himmel
02/04/2016 18:00,549,226,323,14,4,Klarer Himmel
02/04/2016 19:00,460,186,274,14,6,Klarer Himmel
02/04/2016 20:00,352,171,181,12,6,Klarer Himmel
02/04/2016 21:00,258,128,130,12,6,Klarer Himmel
02/04/2016 22:00,236,147,89,13,6,Klarer Himmel
02/04/2016 23:00,182,94,88,13,6,Klarer Himmel
03/04/2016 00:00,175,102,73,12,7,Klarer Himmel
03/04/2016 01:00,158,84,74,12,2,Klarer Himmel
03/04/2016 02:00,111,56,55,11,6,Klarer Himmel
03/04/2016 03:00,86,52,34,12,6,Regen
03/04/2016 04:00,50,28,22,11,4,Klarer Himmel
03/04/2016 05:00,41,31,10,11,6,Klarer Himmel
03/04/2016 06:00,41,25,16,11,6,Klarer Himmel
03/04/2016 07:00,52,16,36,11,4,Klarer Himmel
03/04/2016 08:00,70,32,38,12,9,Klarer Himmel
03/04/2016 09:00,131,74,57,13,6,Klarer Himmel
03/04/2016 10:00,237,127,110,14,9,Klarer Himmel
03/04/2016 11:00,221,119,102,15,11,wolkig
03/04/2016 12:00,284,144,140,16,7,wolkig
03/04/2016 13:00,346,201,145,17,11,Klarer Himmel
03/04/2016 14:00,453,280,173,19,13,Klarer Himmel
03/04/2016 15:00,476,296,180,20,9,wolkig
03/04/2016 16:00,501,259,242,20,19,wolkig
03/04/2016 17:00,520,254,266,20,9,wolkig
03/04/2016 18:00,451,222,229,20,7,wolkig
03/04/2016 19:00,379,208,171,19,2,wolkig
03/04/2016 20:00,244,141,103,18,6,wolkig
03/04/2016 21:00,179,100,79,18,11,Klarer Himmel
03/04/2016 22:00,133,77,56,17,13,Klarer Himmel
03/04/2016 23:00,71,43,28,16,11,Regen
04/04/2016 00:00,38,18,20,15,11,Regen
04/04/2016 01:00,23,11,12,15,11,Regen
04/04/2016 02:00,7,5,2,14,7,Regen
04/04/2016 03:00,9,6,3,13,9,Klarer Himmel
04/04/2016 04:00,17,7,10,14,13,Klarer Himmel
04/04/2016 05:00,81,42,39,14,11,Klarer Himmel
04/04/2016 06:00,330,160,170,13,15,Klarer Himmel
04/04/2016 07:00,973,650,323,14,13,wolkig
04/04/2016 08:00,830,567,263,15,13,wolkig
04/04/2016 09:00,633,436,197,17,19,teilweise bewölkt
04/04/2016 10:00,564,363,201,17,19,teilweise bewölkt
04/04/2016 11:00,577,324,253,18,19,wolkig
04/04/2016 12:00,631,304,327,19,22,teilweise bewölkt
04/04/2016 13:00,706,357,349,18,32,wolkig
04/04/2016 14:00,697,321,376,15,32,wolkig
04/04/2016 15:00,793,357,436,16,22,wolkig
04/04/2016 16:00,952,423,529,16,19,wolkig
04/04/2016 17:00,1029,497,532,15,19,wolkig
04/04/2016 18:00,882,376,506,15,11,wolkig
04/04/2016 19:00,720,329,391,14,7,Klarer Himmel
04/04/2016 20:00,447,203,244,11,2,Klarer Himmel
04/04/2016 21:00,294,148,146,9,4,Klarer Himmel
04/04/2016 22:00,262,130,132,11,6,Klarer Himmel
04/04/2016 23:00,110,57,53,11,6,Klarer Himmel
05/04/2016 00:00,56,28,28,10,6,teilweise bewölkt
05/04/2016 01:00,24,12,12,10,4,teilweise bewölkt
05/04/2016 02:00,11,4,7,11,6,Klarer Himmel
05/04/2016 03:00,16,4,12,11,4,Klarer Himmel
05/04/2016 04:00,24,6,18,12,4,wolkig
05/04/2016 05:00,89,40,49,12,6,wolkig
05/04/2016 06:00,313,132,181,12,6,wolkig
05/04/2016 07:00,937,618,319,11,11,wolkig
05/04/2016 08:00,818,552,266,12,11,Regen
05/04/2016 09:00,554,386,168,12,11,Regen
05/04/2016 10:00,382,229,153,13,9,Regen
05/04/2016 11:00,384,207,177,13,11,Regen
05/04/2016 12:00,414,198,216,12,9,Regen
05/04/2016 13:00,596,288,308,12,9,Regen
05/04/2016 14:00,572,285,287,12,17,Regen
05/04/2016 15:00,588,261,327,11,17,Regen
05/04/2016 16:00,779,333,446,11,15,Regen
05/04/2016 17:00,849,377,472,11,11,Regen
05/04/2016 18:00,726,330,396,11,11,Regen
05/04/2016 19:00,623,285,338,11,6,wolkig
05/04/2016 20:00,371,170,201,10,9,teilweise bewölkt
05/04/2016 21:00,242,120,122,10,9,
05/04/2016 22:00,235,119,116,9,11,
05/04/2016 23:00,120,48,72,8,7,
06/04/2016 00:00,72,40,32,8,6,
06/04/2016 01:00,35,13,22,7,7,
06/04/2016 02:00,14,8,6,7,9,Nebel
06/04/2016 03:00,9,8,1,7,11,Nebel
06/04/2016 04:00,18,8,10,8,13,wolkig
06/04/2016 05:00,70,36,34,8,15,wolkig
06/04/2016 06:00,339,141,198,8,15,wolkig
06/04/2016 07:00,951,655,296,8,15,wolkig
06/04/2016 08:00,842,581,261,8,15,wolkig
06/04/2016 09:00,653,467,186,8,17,wolkig
06/04/2016 10:00,551,365,186,9,19,wolkig
06/04/2016 11:00,567,310,257,9,20,wolkig
06/04/2016 12:00,679,338,341,11,20,wolkig
06/04/2016 13:00,709,323,386,12,30,teilweise bewölkt
06/04/2016 14:00,696,345,351,12,30,wolkig
06/04/2016 15:00,793,361,432,12,33,wolkig
06/04/2016 16:00,881,375,506,12,28,Regen
06/04/2016 17:00,987,449,538,12,26,Regen
06/04/2016 18:00,882,375,507,12,26,Regen
06/04/2016 19:00,603,269,334,11,20,wolkig
06/04/2016 20:00,411,198,213,11,22,Regen
06/04/2016 21:00,293,131,162,9,20,Regen
06/04/2016 22:00,266,148,118,8,46,Regen
06/04/2016 23:00,139,68,71,7,20,Klarer Himmel
07/04/2016 00:00,82,39,43,7,17,Regen
07/04/2016 01:00,63,23,40,7,15,wolkig
07/04/2016 02:00,26,10,16,6,13,teilweise bewölkt
07/04/2016 03:00,35,14,21,6,15,teilweise bewölkt
07/04/2016 04:00,38,16,22,6,22,teilweise bewölkt
07/04/2016 05:00,87,42,45,6,17,Klarer Himmel
07/04/2016 06:00,313,137,176,6,15,teilweise bewölkt
07/04/2016 07:00,945,617,328,6,13,teilweise bewölkt
07/04/2016 08:00,785,530,255,6,20,teilweise bewölkt
07/04/2016 09:00,643,452,191,7,22,teilweise bewölkt
07/04/2016 10:00,439,291,148,8,26,teilweise bewölkt
07/04/2016 11:00,523,296,227,9,30,teilweise bewölkt
07/04/2016 12:00,582,297,285,10,30,teilweise bewölkt
07/04/2016 13:00,649,293,356,10,28,wolkig
07/04/2016 14:00,661,323,338,11,33,teilweise bewölkt
07/04/2016 15:00,763,351,412,11,30,teilweise bewölkt
07/04/2016 16:00,944,424,520,12,30,teilweise bewölkt
07/04/2016 17:00,1073,497,576,11,22,teilweise bewölkt
07/04/2016 18:00,941,425,516,10,24,teilweise bewölkt
07/04/2016 19:00,743,322,421,8,13,teilweise bewölkt
07/04/2016 20:00,467,212,255,8,11,teilweise bewölkt
07/04/2016 21:00,285,131,154,7,13,Klarer Himmel
07/04/2016 22:00,212,110,102,7,13,Klarer Himmel
07/04/2016 23:00,221,110,111,7,15,Klarer Himmel
08/04/2016 00:00,92,50,42,6,13,Klarer Himmel
08/04/2016 01:00,46,15,31,5,9,Klarer Himmel
08/04/2016 02:00,11,4,7,5,7,Klarer Himmel
08/04/2016 03:00,17,7,10,3,6,teilweise bewölkt
08/04/2016 04:00,16,9,7,3,6,teilweise bewölkt
08/04/2016 05:00,84,42,42,4,7,wolkig
08/04/2016 06:00,292,139,153,5,13,wolkig
08/04/2016 07:00,895,612,283,5,9,wolkig
08/04/2016 08:00,704,479,225,6,11,wolkig
08/04/2016 09:00,576,411,165,6,11,wolkig
08/04/2016 10:00,500,306,194,7,13,wolkig
08/04/2016 11:00,564,302,262,8,9,wolkig
08/04/2016 12:00,662,328,334,9,13,wolkig
08/04/2016 13:00,834,357,477,10,13,wolkig
08/04/2016 14:00,845,407,438,11,11,wolkig
08/04/2016 15:00,817,390,427,11,13,wolkig
08/04/2016 16:00,786,328,458,11,13,wolkig
08/04/2016 17:00,763,331,432,11,13,wolkig
08/04/2016 18:00,742,322,420,11,7,wolkig
08/04/2016 19:00,629,303,326,10,6,wolkig
08/04/2016 20:00,465,236,229,7,4,teilweise bewölkt
08/04/2016 21:00,304,143,161,7,4,Klarer Himmel
08/04/2016 22:00,255,128,127,7,4,Klarer Himmel
08/04/2016 23:00,206,91,115,5,2,Klarer Himmel
09/04/2016 00:00,173,79,94,4,4,Klarer Himmel
09/04/2016 01:00,159,60,99,3,2,Klarer Himmel
09/04/2016 02:00,96,41,55,2,2,Nebel
09/04/2016 03:00,84,53,31,2,2,Nebel
09/04/2016 04:00,50,28,22,1,2,Nebel
09/04/2016 05:00,49,39,10,2,6,Nebel
09/04/2016 06:00,58,29,29,2,6,Nebel
09/04/2016 07:00,139,73,66,3,4,Nebel
09/04/2016 08:00,275,173,102,5,4,
09/04/2016 09:00,461,300,161,7,7,
09/04/2016 10:00,613,448,165,10,11,Klarer Himmel
09/04/2016 11:00,757,492,265,12,11,teilweise bewölkt
09/04/2016 12:00,871,468,403,13,9,teilweise bewölkt
09/04/2016 13:00,908,460,448,13,7,teilweise bewölkt
09/04/2016 14:00,799,364,435,14,15,teilweise bewölkt
09/04/2016 15:00,735,316,419,15,11,Klarer Himmel
09/04/2016 16:00,662,277,385,15,9,Klarer Himmel
09/04/2016 17:00,629,284,345,15,9,teilweise bewölkt
09/04/2016 18:00,646,301,345,14,13,Klarer Himmel
09/04/2016 19:00,576,244,332,13,6,Klarer Himmel
09/04/2016 20:00,441,212,229,12,6,Klarer Himmel
09/04/2016 21:00,285,135,150,11,6,Klarer Himmel
09/04/2016 22:00,254,133,121,11,7,Klarer Himmel
09/04/2016 23:00,220,109,111,10,7,Klarer Himmel
10/04/2016 00:00,230,107,123,10,7,Klarer Himmel
10/04/2016 01:00,210,106,104,10,6,Klarer Himmel
10/04/2016 02:00,115,61,54,10,7,Klarer Himmel
10/04/2016 03:00,102,57,45,10,6,Klarer Himmel
10/04/2016 04:00,81,55,26,10,7,Klarer Himmel
10/04/2016 05:00,58,43,15,10,9,Klarer Himmel
10/04/2016 06:00,44,27,17,10,7,Klarer Himmel
10/04/2016 07:00,57,25,32,9,6,Klarer Himmel
10/04/2016 08:00,69,33,36,10,9,Klarer Himmel
10/04/2016 09:00,144,73,71,12,11,Klarer Himmel
10/04/2016 10:00,272,169,103,13,9,wolkig
10/04/2016 11:00,341,198,143,14,9,wolkig
10/04/2016 12:00,397,220,177,15,9,wolkig
10/04/2016 13:00,427,246,181,16,13,wolkig
10/04/2016 14:00,546,325,221,16,9,teilweise bewölkt
10/04/2016 15:00,529,300,229,17,11,teilweise bewölkt
10/04/2016 16:00,515,274,241,17,15,teilweise bewölkt
10/04/2016 17:00,596,317,279,16,11,teilweise bewölkt
10/04/2016 18:00,519,252,267,15,7,Klarer Himmel
10/04/2016 19:00,451,206,245,15,7,Klarer Himmel
10/04/2016 20:00,348,159,189,13,6,Klarer Himmel
10/04/2016 21:00,227,119,108,12,7,Klarer Himmel
10/04/2016 22:00,161,95,66,11,7,Klarer Himmel
10/04/2016 23:00,78,42,36,11,9,Klarer Himmel
11/04/2016 00:00,41,25,16,10,11,Klarer Himmel
11/04/2016 01:00,16,10,6,9,11,Klarer Himmel
11/04/2016 02:00,4,2,2,8,11,Klarer Himmel
11/04/2016 03:00,3,1,2,8,13,Klarer Himmel
11/04/2016 04:00,10,3,7,8,9,Klarer Himmel
11/04/2016 05:00,72,33,39,7,11,Klarer Himmel
11/04/2016 06:00,331,164,167,7,11,Klarer Himmel
11/04/2016 07:00,1083,730,353,7,11,Klarer Himmel
11/04/2016 08:00,918,635,283,9,15,Klarer Himmel
11/04/2016 09:00,758,548,210,10,17,Klarer Himmel
11/04/2016 10:00,607,389,218,11,19,Klarer Himmel
11/04/2016 11:00,682,373,309,12,17,teilweise bewölkt
11/04/2016 12:00,695,346,349,13,13,teilweise bewölkt
11/04/2016 13:00,846,443,403,14,19,Klarer Himmel
11/04/2016 14:00,745,375,370,16,15,Klarer Himmel
11/04/2016 15:00,942,445,497,16,17,Klarer Himmel
11/04/2016 16:00,1038,448,590,16,15,Klarer Himmel
11/04/2016 17:00,1240,559,681,16,13,Klarer Himmel
11/04/2016 18:00,1090,454,636,16,17,Klarer Himmel
11/04/2016 19:00,870,369,501,14,13,Klarer Himmel
11/04/2016 20:00,519,235,284,13,9,Klarer Himmel
11/04/2016 21:00,409,202,207,12,9,Klarer Himmel
11/04/2016 22:00,282,158,124,11,7,Klarer Himmel
11/04/2016 23:00,163,67,96,10,9,Klarer Himmel
12/04/2016 00:00,88,38,50,9,7,Klarer Himmel
12/04/2016 01:00,49,24,25,9,9,Klarer Himmel
12/04/2016 02:00,20,11,9,9,7,Klarer Himmel
12/04/2016 03:00,20,15,5,8,7,Klarer Himmel
12/04/2016 04:00,16,11,5,8,6,Klarer Himmel
12/04/2016 05:00,78,35,43,8,11,
12/04/2016 06:00,371,164,207,8,7,
12/04/2016 07:00,1092,746,346,8,7,Regen
12/04/2016 08:00,941,658,283,9,4,
12/04/2016 09:00,762,564,198,10,7,
12/04/2016 10:00,630,372,258,13,4,teilweise bewölkt
12/04/2016 11:00,583,342,241,15,9,Klarer Himmel
12/04/2016 12:00,694,336,358,16,7,teilweise bewölkt
12/04/2016 13:00,842,418,424,18,9,teilweise bewölkt
12/04/2016 14:00,830,397,433,18,6,teilweise bewölkt
12/04/2016 15:00,1019,486,533,18,7,Klarer Himmel
12/04/2016 16:00,1056,444,612,18,7,Klarer Himmel
12/04/2016 17:00,1212,568,644,18,4,Klarer Himmel
12/04/2016 18:00,1063,480,583,18,6,Klarer Himmel
12/04/2016 19:00,813,351,462,16,4,Klarer Himmel
12/04/2016 20:00,644,296,348,15,6,Klarer Himmel
12/04/2016 21:00,311,157,154,12,22,
12/04/2016 22:00,378,173,205,11,13,Regen
12/04/2016 23:00,238,88,150,10,4,wolkig
13/04/2016 00:00,135,43,92,10,13,wolkig
13/04/2016 01:00,35,18,17,10,9,wolkig
13/04/2016 02:00,30,24,6,9,6,wolkig
13/04/2016 03:00,41,35,6,8,2,Nebel
13/04/2016 04:00,40,33,7,9,7,wolkig
13/04/2016 05:00,81,39,42,8,6,wolkig
13/04/2016 06:00,331,141,190,8,6,Nebel
13/04/2016 07:00,1134,812,322,8,7,teilweise bewölkt
13/04/2016 08:00,988,683,305,9,4,wolkig
13/04/2016 09:00,753,560,193,10,4,wolkig
13/04/2016 10:00,655,386,269,11,4,wolkig
13/04/2016 11:00,710,432,278,12,4,wolkig
13/04/2016 12:00,765,362,403,13,6,wolkig
13/04/2016 13:00,875,425,450,13,6,wolkig
13/04/2016 14:00,852,352,500,14,4,wolkig
13/04/2016 15:00,930,413,517,14,6,wolkig
13/04/2016 16:00,1002,435,567,14,9,wolkig
13/04/2016 17:00,1088,520,568,14,9,wolkig
13/04/2016 18:00,1015,454,561,14,7,wolkig
13/04/2016 19:00,790,389,401,13,6,wolkig
13/04/2016 20:00,631,305,326,10,24,Regen
13/04/2016 21:00,408,184,224,9,2,wolkig
13/04/2016 22:00,352,186,166,9,6,wolkig
13/04/2016 23:00,193,85,108,9,2,wolkig
14/04/2016 00:00,160,73,87,8,4,wolkig
14/04/2016 01:00,87,29,58,7,2,Nebel
14/04/2016 02:00,46,12,34,6,7,Nebel
14/04/2016 03:00,59,24,35,6,4,Nebel
14/04/2016 04:00,43,17,26,4,4,Nebel
14/04/2016 05:00,95,42,53,3,6,Nebel
14/04/2016 06:00,320,133,187,4,2,Nebel
14/04/2016 07:00,1074,736,338,4,2,Nebel
14/04/2016 08:00,885,624,261,7,6,
14/04/2016 09:00,725,546,179,10,4,Klarer Himmel
14/04/2016 10:00,567,368,199,13,4,Klarer Himmel
14/04/2016 11:00,664,392,272,14,7,teilweise bewölkt
14/04/2016 12:00,767,365,402,14,13,teilweise bewölkt
14/04/2016 13:00,893,428,465,16,13,teilweise bewölkt
14/04/2016 14:00,793,385,408,15,15,Klarer Himmel
14/04/2016 15:00,941,414,527,16,13,teilweise bewölkt
14/04/2016 16:00,1081,469,612,15,15,teilweise bewölkt
14/04/2016 17:00,1178,520,658,14,11,wolkig
14/04/2016 18:00,1045,479,566,14,6,wolkig
14/04/2016 19:00,829,379,450,14,4,Klarer Himmel
14/04/2016 20:00,602,235,367,11,4,Klarer Himmel
14/04/2016 21:00,336,148,188,8,4,Klarer Himmel
14/04/2016 22:00,268,136,132,7,4,Klarer Himmel
14/04/2016 23:00,266,116,150,8,4,Klarer Himmel
15/04/2016 00:00,92,38,54,10,2,wolkig
15/04/2016 01:00,56,31,25,10,7,Regen
15/04/2016 02:00,27,15,12,9,6,Klarer Himmel
15/04/2016 03:00,23,13,10,8,11,Klarer Himmel
15/04/2016 04:00,28,15,13,8,11,Klarer Himmel
15/04/2016 05:00,78,28,50,10,13,Regen
15/04/2016 06:00,282,125,157,9,4,Regen
15/04/2016 07:00,768,525,243,9,4,Regen
15/04/2016 08:00,599,433,166,9,6,Regen
15/04/2016 09:00,485,343,142,9,6,wolkig
15/04/2016 10:00,472,267,205,10,7,wolkig
15/04/2016 11:00,544,295,249,12,15,Regen
15/04/2016 12:00,620,310,310,11,17,Regen
15/04/2016 13:00,681,285,396,12,20,Regen
15/04/2016 14:00,735,343,392,11,32,Regen
15/04/2016 15:00,695,319,376,12,24,Regen
15/04/2016 16:00,655,293,362,12,19,wolkig
15/04/2016 17:00,760,374,386,12,28,Klarer Himmel
15/04/2016 18:00,680,321,359,13,17,teilweise bewölkt
15/04/2016 19:00,597,292,305,12,9,teilweise bewölkt
15/04/2016 20:00,580,307,273,8,6,teilweise bewölkt
15/04/2016 21:00,376,146,230,9,2,wolkig
15/04/2016 22:00,327,118,209,7,6,Klarer Himmel
15/04/2016 23:00,266,104,162,6,4,Klarer Himmel
16/04/2016 00:00,209,96,113,6,6,Klarer Himmel
16/04/2016 01:00,164,79,85,7,4,teilweise bewölkt
16/04/2016 02:00,117,57,60,8,7,teilweise bewölkt
16/04/2016 03:00,84,55,29,9,7,wolkig
16/04/2016 04:00,48,27,21,9,13,wolkig
16/04/2016 05:00,55,32,23,10,17,teilweise bewölkt
16/04/2016 06:00,55,27,28,11,17,wolkig
16/04/2016 07:00,147,75,72,11,24,wolkig
16/04/2016 08:00,230,143,87,10,32,Regen
16/04/2016 09:00,399,273,126,11,15,wolkig
16/04/2016 10:00,541,354,187,12,37,teilweise bewölkt
16/04/2016 11:00,626,380,246,13,28,teilweise bewölkt
16/04/2016 12:00,706,358,348,13,28,teilweise bewölkt
16/04/2016 13:00,660,315,345,15,26,Regen
16/04/2016 14:00,645,291,354,11,35,Regen
16/04/2016 15:00,613,273,340,13,32,Regen
16/04/2016 16:00,584,236,348,12,22,Regen
16/04/2016 17:00,561,253,308,11,19,Regen
16/04/2016 18:00,556,210,346,11,22,Regen
16/04/2016 19:00,397,184,213,10,19,wolkig
16/04/2016 20:00,379,194,185,9,17,wolkig
16/04/2016 21:00,276,147,129,8,15,wolkig
16/04/2016 22:00,249,137,112,7,9,wolkig
16/04/2016 23:00,166,90,76,6,6,wolkig
17/04/2016 00:00,196,90,106,6,7,teilweise bewölkt
17/04/2016 01:00,153,64,89,5,6,Klarer Himmel
17/04/2016 02:00,135,58,77,3,6,Klarer Himmel
17/04/2016 03:00,100,54,46,3,6,teilweise bewölkt
17/04/2016 04:00,63,47,16,4,6,wolkig
17/04/2016 05:00,45,33,12,4,4,wolkig
17/04/2016 06:00,46,23,23,5,7,wolkig
17/04/2016 07:00,46,21,25,5,7,Regen
17/04/2016 08:00,91,50,41,6,13,Regen
17/04/2016 09:00,185,104,81,7,13,Regen
17/04/2016 10:00,210,119,91,7,13,wolkig
17/04/2016 11:00,271,146,125,9,19,teilweise bewölkt
17/04/2016 12:00,314,155,159,10,19,teilweise bewölkt
17/04/2016 13:00,384,197,187,10,17,teilweise bewölkt
17/04/2016 14:00,435,206,229,9,20,Regen
17/04/2016 15:00,450,245,205,10,20,teilweise bewölkt
17/04/2016 16:00,486,250,236,9,15,Regen
17/04/2016 17:00,518,278,240,9,17,Regen
17/04/2016 18:00,546,317,229,8,15,teilweise bewölkt
17/04/2016 19:00,359,228,131,8,9,teilweise bewölkt
17/04/2016 20:00,327,190,137,7,6,teilweise bewölkt
17/04/2016 21:00,225,127,98,4,2,Klarer Himmel
17/04/2016 22:00,186,115,71,4,2,Klarer Himmel
17/04/2016 23:00,89,52,37,3,4,teilweise bewölkt
18/04/2016 00:00,42,22,20,3,6,teilweise bewölkt
18/04/2016 01:00,17,7,10,2,2,Klarer Himmel
18/04/2016 02:00,2,0,2,2,2,Klarer Himmel
18/04/2016 03:00,7,3,4,0,2,Klarer Himmel
18/04/2016 04:00,12,5,7,0,2,Nebel
18/04/2016 05:00,84,39,45,0,4,Nebel
18/04/2016 06:00,333,170,163,0,2,Nebel
18/04/2016 07:00,1033,707,326,2,4,Klarer Himmel
18/04/2016 08:00,943,671,272,6,11,Klarer Himmel
18/04/2016 09:00,751,549,202,8,20,Klarer Himmel
18/04/2016 10:00,607,387,220,9,20,teilweise bewölkt
18/04/2016 11:00,701,401,300,11,24,teilweise bewölkt
18/04/2016 12:00,670,349,321,11,28,teilweise bewölkt
18/04/2016 13:00,771,391,380,11,24,wolkig
18/04/2016 14:00,752,376,376,11,22,wolkig
18/04/2016 15:00,809,388,421,12,24,wolkig
18/04/2016 16:00,1033,435,598,12,28,wolkig
18/04/2016 17:00,1107,498,609,12,30,wolkig
18/04/2016 18:00,990,429,561,11,28,wolkig
18/04/2016 19:00,842,333,509,11,20,wolkig
18/04/2016 20:00,482,190,292,10,20,teilweise bewölkt
18/04/2016 21:00,324,150,174,9,17,Klarer Himmel
18/04/2016 22:00,253,125,128,9,20,wolkig
18/04/2016 23:00,127,66,61,9,17,Klarer Himmel
19/04/2016 00:00,54,23,31,9,17,Klarer Himmel
19/04/2016 01:00,27,15,12,9,15,wolkig
19/04/2016 02:00,12,3,9,8,22,wolkig
19/04/2016 03:00,6,2,4,8,15,wolkig
19/04/2016 04:00,15,6,9,8,17,wolkig
19/04/2016 05:00,88,40,48,8,15,wolkig
19/04/2016 06:00,334,139,195,8,17,Klarer Himmel
19/04/2016 07:00,1094,743,351,8,17,Klarer Himmel
19/04/2016 08:00,947,686,261,9,17,wolkig
19/04/2016 09:00,757,551,206,10,22,wolkig
19/04/2016 10:00,544,336,208,11,22,wolkig
19/04/2016 11:00,593,328,265,12,19,teilweise bewölkt
19/04/2016 12:00,707,323,384,13,17,wolkig
19/04/2016 13:00,744,314,430,14,20,wolkig
19/04/2016 14:00,767,366,401,13,19,teilweise bewölkt
19/04/2016 15:00,853,403,450,12,19,teilweise bewölkt
19/04/2016 16:00,1026,421,605,13,24,teilweise bewölkt
19/04/2016 17:00,1199,519,680,13,26,teilweise bewölkt
19/04/2016 18:00,1038,450,588,12,24,teilweise bewölkt
19/04/2016 19:00,860,376,484,10,20,teilweise bewölkt
19/04/2016 20:00,579,236,343,8,17,teilweise bewölkt
19/04/2016 21:00,332,146,186,7,13,Klarer Himmel
19/04/2016 22:00,349,185,164,7,11,teilweise bewölkt
19/04/2016 23:00,135,63,72,6,11,teilweise bewölkt
20/04/2016 00:00,63,33,30,5,6,Klarer Himmel
20/04/2016 01:00,39,19,20,4,4,Klarer Himmel
20/04/2016 02:00,17,4,13,2,6,Klarer Himmel
20/04/2016 03:00,15,5,10,2,4,Klarer Himmel
20/04/2016 04:00,15,6,9,1,0,teilweise bewölkt
20/04/2016 05:00,90,41,49,1,4,Nebel
20/04/2016 06:00,354,147,207,1,4,Nebel
20/04/2016 07:00,1102,755,347,3,2,teilweise bewölkt
20/04/2016 08:00,965,692,273,6,7,teilweise bewölkt
20/04/2016 09:00,753,547,206,8,11,teilweise bewölkt
20/04/2016 10:00,672,403,269,9,9,teilweise bewölkt
20/04/2016 11:00,713,451,262,10,11,teilweise bewölkt
20/04/2016 12:00,804,404,400,10,11,teilweise bewölkt
20/04/2016 13:00,828,426,402,11,9,teilweise bewölkt
20/04/2016 14:00,874,375,499,12,7,Klarer Himmel
20/04/2016 15:00,928,442,486,13,9,Klarer Himmel
20/04/2016 16:00,1083,461,622,13,11,Klarer Himmel
20/04/2016 17:00,1156,559,597,13,15,Klarer Himmel
20/04/2016 18:00,1111,481,630,13,11,Klarer Himmel
20/04/2016 19:00,870,378,492,12,11,Klarer Himmel
20/04/2016 20:00,617,260,357,9,7,Klarer Himmel
20/04/2016 21:00,425,173,252,9,13,Klarer Himmel
20/04/2016 22:00,346,160,186,8,15,Klarer Himmel
20/04/2016 23:00,217,95,122,6,9,Klarer Himmel
21/04/2016 00:00,139,60,79,5,7,Klarer Himmel
21/04/2016 01:00,59,25,34,4,4,Klarer Himmel
21/04/2016 02:00,37,14,23,3,4,Klarer Himmel
21/04/2016 03:00,61,45,16,3,2,Klarer Himmel
21/04/2016 04:00,40,24,16,2,6,Klarer Himmel
21/04/2016 05:00,97,48,49,3,6,Klarer Himmel
21/04/2016 06:00,363,168,195,3,2,Klarer Himmel
21/04/2016 07:00,1120,766,354,5,6,Klarer Himmel
21/04/2016 08:00,898,633,265,7,6,Klarer Himmel
21/04/2016 09:00,826,610,216,10,6,Klarer Himmel
21/04/2016 10:00,597,356,241,11,9,Klarer Himmel
21/04/2016 11:00,657,369,288,12,9,Klarer Himmel
21/04/2016 12:00,779,362,417,14,9,Klarer Himmel
21/04/2016 13:00,860,428,432,14,9,Klarer Himmel
21/04/2016 14:00,840,390,450,16,9,Klarer Himmel
21/04/2016 15:00,982,464,518,16,13,Klarer Himmel
21/04/2016 16:00,1105,494,611,16,13,Klarer Himmel
21/04/2016 17:00,1260,574,686,16,9,Klarer Himmel
21/04/2016 18:00,1094,500,594,15,15,Klarer Himmel
21/04/2016 19:00,982,430,552,14,13,Klarer Himmel
21/04/2016 20:00,625,261,364,11,9,Klarer Himmel
21/04/2016 21:00,432,208,224,8,7,Klarer Himmel
21/04/2016 22:00,361,208,153,9,17,Klarer Himmel
21/04/2016 23:00,223,128,95,8,20,Klarer Himmel
22/04/2016 00:00,99,51,48,6,11,Klarer Himmel
22/04/2016 01:00,48,23,25,4,4,Klarer Himmel
22/04/2016 02:00,21,10,11,4,2,Klarer Himmel
22/04/2016 03:00,15,4,11,2,9,Klarer Himmel
22/04/2016 04:00,14,5,9,2,2,Klarer Himmel
22/04/2016 05:00,86,35,51,2,2,Nebel
22/04/2016 06:00,289,127,162,2,4,Nebel
22/04/2016 07:00,1003,704,299,5,6,Klarer Himmel
22/04/2016 08:00,868,587,281,7,15,wolkig
22/04/2016 09:00,654,469,185,8,22,wolkig
22/04/2016 10:00,609,377,232,9,13,wolkig
22/04/2016 11:00,623,330,293,10,7,wolkig
22/04/2016 12:00,766,367,399,11,11,wolkig
22/04/2016 13:00,975,411,564,12,11,Klarer Himmel
22/04/2016 14:00,928,413,515,13,4,Klarer Himmel
22/04/2016 15:00,908,441,467,13,15,Klarer Himmel
22/04/2016 16:00,935,434,501,13,13,Klarer Himmel
22/04/2016 17:00,928,445,483,13,13,Klarer Himmel
22/04/2016 18:00,879,377,502,12,15,Klarer Himmel
22/04/2016 19:00,739,311,428,11,15,Klarer Himmel
22/04/2016 20:00,543,225,318,10,17,Klarer Himmel
22/04/2016 21:00,354,182,172,9,15,Klarer Himmel
22/04/2016 22:00,385,218,167,8,15,Klarer Himmel
22/04/2016 23:00,266,146,120,7,15,Klarer Himmel
23/04/2016 00:00,230,120,110,6,11,Klarer Himmel
23/04/2016 01:00,162,64,98,6,7,Klarer Himmel
23/04/2016 02:00,130,68,62,5,7,Klarer Himmel
23/04/2016 03:00,96,48,48,5,7,Klarer Himmel
23/04/2016 04:00,62,38,24,4,7,Klarer Himmel
23/04/2016 05:00,56,34,22,4,4,Klarer Himmel
23/04/2016 06:00,70,37,33,4,6,Klarer Himmel
23/04/2016 07:00,146,81,65,4,11,wolkig
23/04/2016 08:00,254,162,92,6,15,wolkig
23/04/2016 09:00,454,289,165,6,15,wolkig
23/04/2016 10:00,502,340,162,6,13,teilweise bewölkt
23/04/2016 11:00,565,342,223,7,15,teilweise bewölkt
23/04/2016 12:00,628,336,292,7,20,teilweise bewölkt
23/04/2016 13:00,663,346,317,9,17,wolkig
23/04/2016 14:00,652,282,370,9,13,teilweise bewölkt
23/04/2016 15:00,497,207,290,7,20,teilweise bewölkt
23/04/2016 16:00,438,181,257,9,22,teilweise bewölkt
23/04/2016 17:00,477,193,284,8,19,teilweise bewölkt
23/04/2016 18:00,459,174,285,7,9,teilweise bewölkt
23/04/2016 19:00,397,187,210,6,17,Regen
23/04/2016 20:00,329,164,165,5,13,teilweise bewölkt
23/04/2016 21:00,265,136,129,5,11,teilweise bewölkt
23/04/2016 22:00,218,122,96,3,6,teilweise bewölkt
23/04/2016 23:00,181,86,95,3,9,teilweise bewölkt
24/04/2016 00:00,181,96,85,2,11,teilweise bewölkt
24/04/2016 01:00,136,69,67,2,11,Klarer Himmel
24/04/2016 02:00,130,65,65,3,13,wolkig
24/04/2016 03:00,70,31,39,2,11,teilweise bewölkt
24/04/2016 04:00,68,43,25,2,13,teilweise bewölkt
24/04/2016 05:00,54,37,17,1,13,teilweise bewölkt
24/04/2016 06:00,45,22,23,1,15,teilweise bewölkt
24/04/2016 07:00,54,29,25,2,17,teilweise bewölkt
24/04/2016 08:00,84,50,34,4,19,teilweise bewölkt
24/04/2016 09:00,181,112,69,5,24,teilweise bewölkt
24/04/2016 10:00,182,98,84,6,19,teilweise bewölkt
24/04/2016 11:00,193,86,107,5,22,teilweise bewölkt
24/04/2016 12:00,261,129,132,5,4,teilweise bewölkt
24/04/2016 13:00,252,117,135,6,19,teilweise bewölkt
24/04/2016 14:00,326,163,163,8,24,teilweise bewölkt
24/04/2016 15:00,257,161,96,7,30,teilweise bewölkt
24/04/2016 16:00,317,159,158,5,6,teilweise bewölkt
24/04/2016 17:00,368,196,172,6,7,teilweise bewölkt
24/04/2016 18:00,352,188,164,6,20,wolkig
24/04/2016 19:00,280,149,131,6,9,teilweise bewölkt
24/04/2016 20:00,243,151,92,4,13,Regen
24/04/2016 21:00,193,117,76,4,19,teilweise bewölkt
24/04/2016 22:00,149,99,50,1,11,teilweise bewölkt
24/04/2016 23:00,81,55,26,1,11,teilweise bewölkt
25/04/2016 00:00,33,22,11,1,7,wolkig
25/04/2016 01:00,18,12,6,1,9,teilweise bewölkt
25/04/2016 02:00,3,1,2,0,9,Klarer Himmel
25/04/2016 03:00,2,0,2,1,9,teilweise bewölkt
25/04/2016 04:00,16,7,9,0,7,teilweise bewölkt
25/04/2016 05:00,84,42,42,1,9,Nebel
25/04/2016 06:00,283,118,165,1,13,teilweise bewölkt
25/04/2016 07:00,953,651,302,2,11,Klarer Himmel
25/04/2016 08:00,867,603,264,4,19,teilweise bewölkt
25/04/2016 09:00,702,505,197,6,19,wolkig
25/04/2016 10:00,546,358,188,6,28,wolkig
25/04/2016 11:00,503,288,215,7,24,teilweise bewölkt
25/04/2016 12:00,619,307,312,9,28,wolkig
25/04/2016 13:00,705,352,353,8,32,Regen
25/04/2016 14:00,683,332,351,8,22,wolkig
25/04/2016 15:00,781,368,413,7,32,Regen
25/04/2016 16:00,844,348,496,6,22,Regen
25/04/2016 17:00,784,322,462,4,19,Regen
25/04/2016 18:00,712,285,427,4,13,Regen
25/04/2016 19:00,562,256,306,3,17,Regen
25/04/2016 20:00,366,165,201,3,7,wolkig
25/04/2016 21:00,213,101,112,3,9,wolkig
25/04/2016 22:00,173,74,99,4,17,wolkig
25/04/2016 23:00,88,41,47,3,13,wolkig
26/04/2016 00:00,56,18,38,3,17,wolkig
26/04/2016 01:00,35,8,27,2,15,teilweise bewölkt
26/04/2016 02:00,21,3,18,2,13,teilweise bewölkt
26/04/2016 03:00,16,1,15,1,15,Klarer Himmel
26/04/2016 04:00,19,9,10,1,13,Klarer Himmel
26/04/2016 05:00,77,41,36,1,13,Klarer Himmel
26/04/2016 06:00,346,154,192,1,19,Schnee
26/04/2016 07:00,1047,710,337,3,22,wolkig
26/04/2016 08:00,863,618,245,3,30,Schnee
26/04/2016 09:00,558,417,141,3,28,Regen
26/04/2016 10:00,430,278,152,4,30,wolkig
26/04/2016 11:00,485,273,212,5,33,Regen
26/04/2016 12:00,495,227,268,2,9,Schnee
26/04/2016 13:00,620,272,348,6,30,Regen
26/04/2016 14:00,645,302,343,1,13,Schnee
26/04/2016 15:00,716,322,394,6,28,teilweise bewölkt
26/04/2016 16:00,787,311,476,7,22,wolkig
26/04/2016 17:00,952,417,535,6,30,wolkig
26/04/2016 18:00,910,383,527,5,22,Regen
26/04/2016 19:00,682,293,389,4,26,Regen
26/04/2016 20:00,467,198,269,4,26,wolkig
26/04/2016 21:00,290,144,146,4,22,teilweise bewölkt
26/04/2016 22:00,235,130,105,4,32,wolkig
26/04/2016 23:00,142,72,70,4,28,Regen
27/04/2016 00:00,64,33,31,4,32,wolkig
27/04/2016 01:00,21,7,14,3,20,teilweise bewölkt
27/04/2016 02:00,20,6,14,3,19,wolkig
27/04/2016 03:00,19,4,15,2,13,teilweise bewölkt
27/04/2016 04:00,15,9,6,3,11,wolkig
27/04/2016 05:00,72,39,33,3,9,wolkig
27/04/2016 06:00,293,134,159,3,11,Regen
27/04/2016 07:00,769,498,271,3,19,Regen
27/04/2016 08:00,676,490,186,4,17,Regen
27/04/2016 09:00,498,360,138,3,22,Regen
27/04/2016 10:00,515,336,179,5,20,wolkig
27/04/2016 11:00,560,350,210,7,20,Regen
27/04/2016 12:00,586,302,284,8,24,Regen
27/04/2016 13:00,675,344,331,4,30,Regen
27/04/2016 14:00,562,268,294,4,9,wolkig
27/04/2016 15:00,683,298,385,8,22,Regen
27/04/2016 16:00,839,342,497,9,24,wolkig
27/04/2016 17:00,843,356,487,9,20,wolkig
27/04/2016 18:00,767,320,447,5,24,Regen
27/04/2016 19:00,639,298,341,6,7,wolkig
27/04/2016 20:00,475,213,262,5,9,wolkig
27/04/2016 21:00,311,137,174,5,7,teilweise bewölkt
27/04/2016 22:00,274,130,144,4,17,teilweise bewölkt
27/04/2016 23:00,165,88,77,4,11,Klarer Himmel
28/04/2016 00:00,131,46,85,2,9,Klarer Himmel
28/04/2016 01:00,50,17,33,2,11,Klarer Himmel
28/04/2016 02:00,30,11,19,2,11,Klarer Himmel
28/04/2016 03:00,33,15,18,2,13,Klarer Himmel
28/04/2016 04:00,38,17,21,1,11,Klarer Himmel
28/04/2016 05:00,82,37,45,2,9,teilweise bewölkt
28/04/2016 06:00,305,142,163,1,11,teilweise bewölkt
28/04/2016 07:00,912,620,292,2,11,teilweise bewölkt
28/04/2016 08:00,872,611,261,5,19,teilweise bewölkt
28/04/2016 09:00,759,552,207,7,17,teilweise bewölkt
28/04/2016 10:00,521,327,194,7,13,teilweise bewölkt
28/04/2016 11:00,558,318,240,6,20,Regen
28/04/2016 12:00,623,267,356,7,9,wolkig
28/04/2016 13:00,723,345,378,8,22,Regen
28/04/2016 14:00,713,324,389,11,9,teilweise bewölkt
28/04/2016 15:00,895,443,452,10,17,teilweise bewölkt
28/04/2016 16:00,945,387,558,10,20,Regen
28/04/2016 17:00,1024,484,540,9,13,wolkig
28/04/2016 18:00,983,406,577,7,13,wolkig
28/04/2016 19:00,720,326,394,6,9,wolkig
28/04/2016 20:00,436,178,258,6,13,Klarer Himmel
28/04/2016 21:00,329,144,185,5,9,Klarer Himmel
28/04/2016 22:00,321,163,158,5,9,Klarer Himmel
28/04/2016 23:00,196,97,99,5,9,Klarer Himmel
29/04/2016 00:00,103,49,54,4,9,Klarer Himmel
29/04/2016 01:00,32,16,16,3,7,
29/04/2016 02:00,28,17,11,3,11,
29/04/2016 03:00,29,15,14,3,15,Klarer Himmel
29/04/2016 04:00,19,9,10,3,15,Klarer Himmel
29/04/2016 05:00,79,37,42,4,17,Klarer Himmel
29/04/2016 06:00,293,135,158,4,17,Klarer Himmel
29/04/2016 07:00,887,622,265,6,20,Klarer Himmel
29/04/2016 08:00,784,556,228,8,19,Klarer Himmel
29/04/2016 09:00,657,455,202,10,26,wolkig
29/04/2016 10:00,534,320,214,10,33,wolkig
29/04/2016 11:00,632,345,287,10,26,wolkig
29/04/2016 12:00,696,313,383,11,26,Regen
29/04/2016 13:00,824,367,457,11,26,Regen
29/04/2016 14:00,779,330,449,8,17,Regen
29/04/2016 15:00,782,349,433,8,13,Regen
29/04/2016 16:00,768,348,420,9,20,Regen
29/04/2016 17:00,783,335,448,9,17,Regen
29/04/2016 18:00,698,282,416,8,19,Regen
29/04/2016 19:00,575,242,333,7,11,Regen
29/04/2016 20:00,364,156,208,7,11,wolkig
29/04/2016 21:00,272,120,152,7,17,wolkig
29/04/2016 22:00,256,126,130,7,13,Klarer Himmel
29/04/2016 23:00,246,119,127,7,9,Klarer Himmel
30/04/2016 00:00,211,116,95,6,7,Klarer Himmel
30/04/2016 01:00,158,73,85,6,7,Klarer Himmel
30/04/2016 02:00,105,58,47,6,7,Klarer Himmel
30/04/2016 03:00,81,46,35,7,7,Regen
30/04/2016 04:00,88,67,21,6,13,Regen
30/04/2016 05:00,51,34,17,5,6,Regen
30/04/2016 06:00,64,34,30,5,4,Regen
30/04/2016 07:00,103,59,44,5,6,Regen
30/04/2016 08:00,178,112,66,6,9,Regen
30/04/2016 09:00,299,198,101,7,7,Regen
30/04/2016 10:00,398,251,147,8,6,Regen
30/04/2016 11:00,509,314,195,8,6,Regen
30/04/2016 12:00,569,334,235,9,4,Regen
30/04/2016 13:00,583,292,291,8,6,Regen
30/04/2016 14:00,556,233,323,10,7,wolkig
30/04/2016 15:00,549,264,285,10,6,wolkig
30/04/2016 16:00,488,218,270,10,4,wolkig
30/04/2016 17:00,484,183,301,11,2,wolkig
30/04/2016 18:00,498,210,288,10,7,wolkig
30/04/2016 19:00,462,181,281,10,6,wolkig
30/04/2016 20:00,353,175,178,9,4,wolkig
30/04/2016 21:00,308,137,171,9,17,wolkig
30/04/2016 22:00,293,135,158,8,17,Klarer Himmel
30/04/2016 23:00,241,124,117,6,15,Klarer Himmel
01/05/2016 00:00,253,117,136,6,15,Klarer Himmel
01/05/2016 01:00,260,158,102,6,13,wolkig
01/05/2016 02:00,161,103,58,6,11,wolkig
01/05/2016 03:00,115,73,42,6,13,wolkig
01/05/2016 04:00,83,56,27,5,13,wolkig
01/05/2016 05:00,64,45,19,5,13,wolkig
01/05/2016 06:00,39,20,19,5,9,wolkig
01/05/2016 07:00,50,20,30,6,17,wolkig
01/05/2016 08:00,92,37,55,7,17,wolkig
01/05/2016 09:00,159,84,75,8,17,wolkig
01/05/2016 10:00,296,124,172,9,19,wolkig
01/05/2016 11:00,400,206,194,11,20,teilweise bewölkt
01/05/2016 12:00,476,266,210,12,19,teilweise bewölkt
01/05/2016 13:00,523,281,242,13,17,teilweise bewölkt
01/05/2016 14:00,574,326,248,13,19,teilweise bewölkt
01/05/2016 15:00,526,301,225,14,19,teilweise bewölkt
01/05/2016 16:00,533,262,271,14,17,teilweise bewölkt
01/05/2016 17:00,549,258,291,14,19,Klarer Himmel
01/05/2016 18:00,517,273,244,14,15,Klarer Himmel
01/05/2016 19:00,455,250,205,13,15,Klarer Himmel
01/05/2016 20:00,401,250,151,11,11,Klarer Himmel
01/05/2016 21:00,251,155,96,9,6,Klarer Himmel
01/05/2016 22:00,174,122,52,7,4,Klarer Himmel
01/05/2016 23:00,92,49,43,7,2,Klarer Himmel
02/05/2016 00:00,52,32,20,6,2,Klarer Himmel
02/05/2016 01:00,18,8,10,5,2,Klarer Himmel
02/05/2016 02:00,11,6,5,4,0,Klarer Himmel
02/05/2016 03:00,6,2,4,3,2,Klarer Himmel
02/05/2016 04:00,13,9,4,3,2,Klarer Himmel
02/05/2016 05:00,81,40,41,2,2,Nebel
02/05/2016 06:00,318,152,166,3,2,Nebel
02/05/2016 07:00,1034,692,342,6,0,Klarer Himmel
02/05/2016 08:00,855,605,250,9,6,Klarer Himmel
02/05/2016 09:00,776,563,213,12,4,Klarer Himmel
02/05/2016 10:00,583,380,203,14,2,
02/05/2016 11:00,646,391,255,16,7,teilweise bewölkt
02/05/2016 12:00,759,423,336,18,11,teilweise bewölkt
02/05/2016 13:00,910,473,437,18,9,Klarer Himmel
02/05/2016 14:00,807,407,400,19,9,Klarer Himmel
02/05/2016 15:00,962,479,483,19,6,Klarer Himmel
02/05/2016 16:00,1110,490,620,19,9,Klarer Himmel
02/05/2016 17:00,1209,557,652,19,11,Klarer Himmel
02/05/2016 18:00,1031,444,587,19,7,Klarer Himmel
02/05/2016 19:00,909,366,543,17,7,Klarer Himmel
02/05/2016 20:00,556,219,337,15,7,Klarer Himmel
02/05/2016 21:00,382,164,218,13,4,Klarer Himmel
02/05/2016 22:00,283,137,146,12,6,Klarer Himmel
02/05/2016 23:00,141,64,77,11,2,Klarer Himmel
03/05/2016 00:00,47,22,25,13,7,Klarer Himmel
03/05/2016 01:00,26,15,11,13,9,Klarer Himmel
03/05/2016 02:00,8,3,5,12,9,Klarer Himmel
03/05/2016 03:00,7,3,4,12,7,wolkig
03/05/2016 04:00,18,5,13,12,7,wolkig
03/05/2016 05:00,87,35,52,12,7,wolkig
03/05/2016 06:00,332,147,185,9,17,Regen
03/05/2016 07:00,767,518,249,8,11,Regen
03/05/2016 08:00,776,549,227,9,11,wolkig
03/05/2016 09:00,697,492,205,9,20,wolkig
03/05/2016 10:00,524,344,180,11,17,teilweise bewölkt
03/05/2016 11:00,605,367,238,13,19,teilweise bewölkt
03/05/2016 12:00,644,320,324,12,26,Regen
03/05/2016 13:00,741,360,381,14,17,teilweise bewölkt
03/05/2016 14:00,714,328,386,14,24,teilweise bewölkt
03/05/2016 15:00,803,378,425,14,26,teilweise bewölkt
03/05/2016 16:00,930,421,509,14,24,teilweise bewölkt
03/05/2016 17:00,1155,542,613,14,20,Klarer Himmel
03/05/2016 18:00,955,411,544,14,22,Klarer Himmel
03/05/2016 19:00,853,372,481,12,26,Klarer Himmel
03/05/2016 20:00,597,251,346,11,13,Klarer Himmel
03/05/2016 21:00,323,135,188,10,11,Klarer Himmel
03/05/2016 22:00,284,139,145,8,9,Klarer Himmel
03/05/2016 23:00,203,89,114,6,4,Klarer Himmel
04/05/2016 00:00,70,30,40,5,4,Klarer Himmel
04/05/2016 01:00,23,13,10,4,2,Klarer Himmel
04/05/2016 02:00,6,2,4,3,0,Klarer Himmel
04/05/2016 03:00,8,2,6,2,2,Klarer Himmel
04/05/2016 04:00,10,4,6,2,4,Nebel
04/05/2016 05:00,95,47,48,1,0,Nebel
04/05/2016 06:00,360,167,193,1,0,Nebel
04/05/2016 07:00,1096,763,333,5,2,Klarer Himmel
04/05/2016 08:00,959,677,282,9,2,teilweise bewölkt
04/05/2016 09:00,813,598,215,10,9,teilweise bewölkt
04/05/2016 10:00,684,461,223,10,6,teilweise bewölkt
04/05/2016 11:00,767,450,317,12,11,teilweise bewölkt
04/05/2016 12:00,866,421,445,12,6,teilweise bewölkt
04/05/2016 13:00,920,441,479,13,9,teilweise bewölkt
04/05/2016 14:00,893,390,503,13,11,Klarer Himmel
04/05/2016 15:00,961,403,558,15,6,Klarer Himmel
04/05/2016 16:00,1057,461,596,15,6,Klarer Himmel
04/05/2016 17:00,1151,534,617,15,9,Klarer Himmel
04/05/2016 18:00,1021,420,601,15,6,Klarer Himmel
04/05/2016 19:00,860,357,503,14,7,Klarer Himmel
04/05/2016 20:00,635,284,351,12,4,Klarer Himmel
04/05/2016 21:00,402,186,216,10,4,Klarer Himmel
04/05/2016 22:00,384,186,198,7,4,Klarer Himmel
04/05/2016 23:00,295,152,143,8,4,Klarer Himmel
05/05/2016 00:00,235,114,121,7,4,Klarer Himmel
05/05/2016 01:00,218,92,126,6,6,Klarer Himmel
05/05/2016 02:00,150,63,87,4,4,Klarer Himmel
05/05/2016 03:00,98,50,48,5,6,Klarer Himmel
05/05/2016 04:00,89,58,31,4,4,Klarer Himmel
05/05/2016 05:00,55,32,23,3,4,Klarer Himmel
05/05/2016 06:00,63,38,25,7,7,Klarer Himmel
05/05/2016 07:00,89,28,61,9,7,Klarer Himmel
05/05/2016 08:00,159,68,91,11,9,Klarer Himmel
05/05/2016 09:00,223,132,91,13,9,Klarer Himmel
05/05/2016 10:00,376,185,191,14,17,Klarer Himmel
05/05/2016 11:00,337,166,171,16,17,Klarer Himmel
05/05/2016 12:00,438,209,229,17,11,Klarer Himmel
05/05/2016 13:00,498,277,221,18,11,Klarer Himmel
05/05/2016 14:00,625,313,312,18,13,Klarer Himmel
05/05/2016 15:00,561,276,285,18,19,Klarer Himmel
05/05/2016 16:00,557,269,288,19,13,Klarer Himmel
05/05/2016 17:00,636,346,290,19,15,Klarer Himmel
05/05/2016 18:00,554,287,267,19,13,Klarer Himmel
05/05/2016 19:00,508,268,240,18,7,Klarer Himmel
05/05/2016 20:00,453,255,198,17,6,Klarer Himmel
05/05/2016 21:00,283,169,114,15,7,Klarer Himmel
05/05/2016 22:00,221,128,93,14,6,Klarer Himmel
05/05/2016 23:00,159,102,57,13,7,Klarer Himmel
06/05/2016 00:00,88,44,44,13,7,Klarer Himmel
06/05/2016 01:00,39,21,18,13,7,Klarer Himmel
06/05/2016 02:00,18,7,11,12,7,Klarer Himmel
06/05/2016 03:00,12,5,7,12,7,Klarer Himmel
06/05/2016 04:00,10,3,7,11,7,Klarer Himmel
06/05/2016 05:00,62,35,27,11,7,Klarer Himmel
06/05/2016 06:00,197,109,88,12,7,Klarer Himmel
06/05/2016 07:00,437,287,150,13,9,Klarer Himmel
06/05/2016 08:00,605,434,171,15,11,Klarer Himmel
06/05/2016 09:00,636,435,201,17,17,Klarer Himmel
06/05/2016 10:00,670,456,214,18,17,Klarer Himmel
06/05/2016 11:00,773,467,306,20,13,Klarer Himmel
06/05/2016 12:00,915,476,439,21,19,Klarer Himmel
06/05/2016 13:00,920,440,480,23,20,Klarer Himmel
06/05/2016 14:00,1018,452,566,23,19,Klarer Himmel
06/05/2016 15:00,897,411,486,24,19,Klarer Himmel
06/05/2016 16:00,885,381,504,25,17,Klarer Himmel
06/05/2016 17:00,918,413,505,25,19,Klarer Himmel
06/05/2016 18:00,840,368,472,24,17,Klarer Himmel
06/05/2016 19:00,764,324,440,24,13,Klarer Himmel
06/05/2016 20:00,493,226,267,22,7,Klarer Himmel
06/05/2016 21:00,384,197,187,19,6,Klarer Himmel
06/05/2016 22:00,302,137,165,18,6,Klarer Himmel
06/05/2016 23:00,237,114,123,17,6,Klarer Himmel
07/05/2016 00:00,212,98,114,16,7,Klarer Himmel
07/05/2016 01:00,139,60,79,16,6,Klarer Himmel
07/05/2016 02:00,104,55,49,15,6,Klarer Himmel
07/05/2016 03:00,56,30,26,14,6,Klarer Himmel
07/05/2016 04:00,55,37,18,14,7,Klarer Himmel
07/05/2016 05:00,49,32,17,13,7,Klarer Himmel
07/05/2016 06:00,71,36,35,14,9,Klarer Himmel
07/05/2016 07:00,150,89,61,16,9,Klarer Himmel
07/05/2016 08:00,291,173,118,18,11,Klarer Himmel
07/05/2016 09:00,503,336,167,20,9,Klarer Himmel
07/05/2016 10:00,760,503,257,22,11,Klarer Himmel
07/05/2016 11:00,879,528,351,23,17,Klarer Himmel
07/05/2016 12:00,903,463,440,24,17,Klarer Himmel
07/05/2016 13:00,866,402,464,25,19,Klarer Himmel
07/05/2016 14:00,857,371,486,25,17,Klarer Himmel
07/05/2016 15:00,737,311,426,25,17,Klarer Himmel
07/05/2016 16:00,671,282,389,25,22,Klarer Himmel
07/05/2016 17:00,728,339,389,25,17,Klarer Himmel
07/05/2016 18:00,697,312,385,25,15,Klarer Himmel
07/05/2016 19:00,585,257,328,24,11,Klarer Himmel
07/05/2016 20:00,463,229,234,22,7,Klarer Himmel
07/05/2016 21:00,339,175,164,20,9,Klarer Himmel
07/05/2016 22:00,309,169,140,20,9,Klarer Himmel
07/05/2016 23:00,316,172,144,18,7,Klarer Himmel
08/05/2016 00:00,224,138,86,18,11,Klarer Himmel
08/05/2016 01:00,166,81,85,17,9,Klarer Himmel
08/05/2016 02:00,101,59,42,16,7,Klarer Himmel
08/05/2016 03:00,97,68,29,16,9,Klarer Himmel
08/05/2016 04:00,50,29,21,15,9,Klarer Himmel
08/05/2016 05:00,35,25,10,15,13,Klarer Himmel
08/05/2016 06:00,37,24,13,16,11,Klarer Himmel
08/05/2016 07:00,52,20,32,17,11,Klarer Himmel
08/05/2016 08:00,102,49,53,18,15,Klarer Himmel
08/05/2016 09:00,228,131,97,20,15,Klarer Himmel
08/05/2016 10:00,365,195,170,22,17,Klarer Himmel
08/05/2016 11:00,359,211,148,23,20,Klarer Himmel
08/05/2016 12:00,531,333,198,23,20,Klarer Himmel
08/05/2016 13:00,631,395,236,23,19,Klarer Himmel
08/05/2016 14:00,648,353,295,24,19,Klarer Himmel
08/05/2016 15:00,694,360,334,25,19,Klarer Himmel
08/05/2016 16:00,648,290,358,25,19,Klarer Himmel
08/05/2016 17:00,674,302,372,24,19,Klarer Himmel
08/05/2016 18:00,604,304,300,24,17,Klarer Himmel
08/05/2016 19:00,518,285,233,23,17,Klarer Himmel
08/05/2016 20:00,411,250,161,21,11,Klarer Himmel
08/05/2016 21:00,279,154,125,20,9,Klarer Himmel
08/05/2016 22:00,232,148,84,19,9,Klarer Himmel
08/05/2016 23:00,109,68,41,18,9,Klarer Himmel
09/05/2016 00:00,48,33,15,18,13,Klarer Himmel
09/05/2016 01:00,18,12,6,17,11,Klarer Himmel
09/05/2016 02:00,3,1,2,17,11,Klarer Himmel
09/05/2016 03:00,4,2,2,16,11,Klarer Himmel
09/05/2016 04:00,17,6,11,16,9,Klarer Himmel
09/05/2016 05:00,79,40,39,16,11,Klarer Himmel
09/05/2016 06:00,365,187,178,16,9,Klarer Himmel
09/05/2016 07:00,1120,755,365,18,11,Klarer Himmel
09/05/2016 08:00,997,702,295,19,15,Klarer Himmel
09/05/2016 09:00,787,557,230,19,13,Klarer Himmel
09/05/2016 10:00,657,425,232,21,13,Klarer Himmel
09/05/2016 11:00,687,395,292,22,19,Klarer Himmel
09/05/2016 12:00,759,356,403,22,17,Klarer Himmel
09/05/2016 13:00,804,409,395,23,17,Klarer Himmel
09/05/2016 14:00,805,380,425,24,17,Klarer Himmel
09/05/2016 15:00,1000,474,526,25,20,Klarer Himmel
09/05/2016 16:00,1142,488,654,25,22,Klarer Himmel
09/05/2016 17:00,1262,640,622,25,20,Klarer Himmel
09/05/2016 18:00,1152,534,618,24,17,Klarer Himmel
09/05/2016 19:00,896,408,488,23,11,Klarer Himmel
09/05/2016 20:00,596,248,348,21,7,Klarer Himmel
09/05/2016 21:00,425,179,246,20,7,Klarer Himmel
09/05/2016 22:00,331,158,173,19,7,Klarer Himmel
09/05/2016 23:00,159,73,86,18,9,Klarer Himmel
10/05/2016 00:00,70,34,36,18,7,Klarer Himmel
10/05/2016 01:00,29,19,10,17,9,Klarer Himmel
10/05/2016 02:00,9,3,6,17,9,Klarer Himmel
10/05/2016 03:00,15,3,12,16,7,Klarer Himmel
10/05/2016 04:00,24,10,14,16,7,Klarer Himmel
10/05/2016 05:00,90,38,52,16,9,wolkig
10/05/2016 06:00,417,215,202,16,9,Klarer Himmel
10/05/2016 07:00,1201,813,388,17,9,Klarer Himmel
10/05/2016 08:00,1060,753,307,19,13,Klarer Himmel
10/05/2016 09:00,817,593,224,21,11,Klarer Himmel
10/05/2016 10:00,657,419,238,22,13,Klarer Himmel
10/05/2016 11:00,655,397,258,23,20,Klarer Himmel
10/05/2016 12:00,744,350,394,24,20,Klarer Himmel
10/05/2016 13:00,846,394,452,24,13,Klarer Himmel
10/05/2016 14:00,824,363,461,24,13,Klarer Himmel
10/05/2016 15:00,972,456,516,24,15,Klarer Himmel
10/05/2016 16:00,1141,483,658,24,13,Klarer Himmel
10/05/2016 17:00,1274,610,664,24,9,Klarer Himmel
10/05/2016 18:00,1164,502,662,23,9,Klarer Himmel
10/05/2016 19:00,927,407,520,22,7,Klarer Himmel
10/05/2016 20:00,589,239,350,21,7,Klarer Himmel
10/05/2016 21:00,411,184,227,21,9,Klarer Himmel
10/05/2016 22:00,335,182,153,20,9,Klarer Himmel
10/05/2016 23:00,190,87,103,19,6,Klarer Himmel
11/05/2016 00:00,70,38,32,19,6,Klarer Himmel
11/05/2016 01:00,35,21,14,18,4,Klarer Himmel
11/05/2016 02:00,14,4,10,18,4,Klarer Himmel
11/05/2016 03:00,12,5,7,17,4,Klarer Himmel
11/05/2016 04:00,21,14,7,17,6,Klarer Himmel
11/05/2016 05:00,97,44,53,16,6,Klarer Himmel
11/05/2016 06:00,399,200,199,16,6,Klarer Himmel
11/05/2016 07:00,1184,825,359,18,7,Klarer Himmel
11/05/2016 08:00,1061,749,312,19,7,Klarer Himmel
11/05/2016 09:00,847,607,240,19,7,Klarer Himmel
11/05/2016 10:00,679,432,247,22,9,
11/05/2016 11:00,759,457,302,23,11,teilweise bewölkt
11/05/2016 12:00,865,455,410,23,17,Klarer Himmel
11/05/2016 13:00,908,455,453,24,15,Klarer Himmel
11/05/2016 14:00,930,398,532,25,17,Klarer Himmel
11/05/2016 15:00,1023,457,566,26,15,Klarer Himmel
11/05/2016 16:00,1107,482,625,25,19,Klarer Himmel
11/05/2016 17:00,1285,638,647,25,20,Klarer Himmel
11/05/2016 18:00,1143,516,627,24,17,Klarer Himmel
11/05/2016 19:00,964,413,551,22,13,Klarer Himmel
11/05/2016 20:00,631,291,340,21,13,Klarer Himmel
11/05/2016 21:00,498,215,283,20,11,Klarer Himmel
11/05/2016 22:00,416,231,185,19,7,Klarer Himmel
11/05/2016 23:00,275,149,126,18,9,Klarer Himmel
12/05/2016 00:00,142,71,71,17,7,Klarer Himmel
12/05/2016 01:00,109,62,47,16,7,Klarer Himmel
12/05/2016 02:00,43,9,34,15,11,Klarer Himmel
12/05/2016 03:00,36,20,16,15,9,Klarer Himmel
12/05/2016 04:00,31,18,13,15,9,Klarer Himmel
12/05/2016 05:00,89,35,54,14,13,Klarer Himmel
12/05/2016 06:00,379,171,208,15,15,Klarer Himmel
12/05/2016 07:00,1123,775,348,16,13,Klarer Himmel
12/05/2016 08:00,997,703,294,18,15,Klarer Himmel
12/05/2016 09:00,812,624,188,20,19,Klarer Himmel
12/05/2016 10:00,619,408,211,21,19,Klarer Himmel
12/05/2016 11:00,718,381,337,22,19,Klarer Himmel
12/05/2016 12:00,791,380,411,24,17,Klarer Himmel
12/05/2016 13:00,912,425,487,24,22,Klarer Himmel
12/05/2016 14:00,862,406,456,24,20,Klarer Himmel
12/05/2016 15:00,1018,452,566,24,19,Klarer Himmel
12/05/2016 16:00,1199,534,665,25,15,Klarer Himmel
12/05/2016 17:00,1282,605,677,23,17,Klarer Himmel
12/05/2016 18:00,1103,497,606,24,17,Klarer Himmel
12/05/2016 19:00,919,424,495,23,15,Klarer Himmel
12/05/2016 20:00,563,257,306,21,7,Klarer Himmel
12/05/2016 21:00,467,196,271,19,11,Klarer Himmel
12/05/2016 22:00,421,200,221,19,19,Klarer Himmel
12/05/2016 23:00,277,147,130,18,17,Klarer Himmel
13/05/2016 00:00,150,85,65,17,11,Klarer Himmel
13/05/2016 01:00,74,39,35,16,11,Klarer Himmel
13/05/2016 02:00,45,18,27,15,15,Klarer Himmel
13/05/2016 03:00,36,16,20,14,17,Klarer Himmel
13/05/2016 04:00,31,14,17,13,13,Klarer Himmel
13/05/2016 05:00,81,36,45,11,11,Klarer Himmel
13/05/2016 06:00,328,150,178,12,11,Klarer Himmel
13/05/2016 07:00,1018,701,317,13,17,Klarer Himmel
13/05/2016 08:00,860,584,276,15,15,Klarer Himmel
13/05/2016 09:00,715,499,216,17,9,Klarer Himmel
13/05/2016 10:00,673,396,277,19,13,Klarer Himmel
13/05/2016 11:00,761,421,340,20,24,Klarer Himmel
13/05/2016 12:00,887,422,465,22,17,Klarer Himmel
13/05/2016 13:00,999,430,569,22,22,Klarer Himmel
13/05/2016 14:00,986,459,527,22,24,Klarer Himmel
13/05/2016 15:00,991,496,495,23,22,Klarer Himmel
13/05/2016 16:00,957,433,524,21,24,Klarer Himmel
13/05/2016 17:00,938,416,522,22,24,Klarer Himmel
13/05/2016 18:00,816,376,440,21,26,Klarer Himmel
13/05/2016 19:00,681,289,392,19,24,Klarer Himmel
13/05/2016 20:00,554,228,326,16,20,Klarer Himmel
13/05/2016 21:00,398,173,225,13,22,Klarer Himmel
13/05/2016 22:00,295,147,148,11,24,Klarer Himmel
13/05/2016 23:00,227,110,117,9,20,Klarer Himmel
14/05/2016 00:00,173,95,78,9,19,wolkig
14/05/2016 01:00,162,71,91,8,20,wolkig
14/05/2016 02:00,70,39,31,8,15,wolkig
14/05/2016 03:00,78,46,32,8,15,wolkig
14/05/2016 04:00,64,39,25,8,13,wolkig
14/05/2016 05:00,57,32,25,7,11,wolkig
14/05/2016 06:00,62,32,30,7,9,wolkig
14/05/2016 07:00,168,98,70,8,17,wolkig
14/05/2016 08:00,233,137,96,8,19,wolkig
14/05/2016 09:00,379,256,123,9,19,wolkig
14/05/2016 10:00,584,361,223,10,20,wolkig
14/05/2016 11:00,646,412,234,10,19,teilweise bewölkt
14/05/2016 12:00,695,382,313,11,20,wolkig
14/05/2016 13:00,696,356,340,11,22,wolkig
14/05/2016 14:00,659,298,361,12,19,teilweise bewölkt
14/05/2016 15:00,585,242,343,11,20,teilweise bewölkt
14/05/2016 16:00,437,177,260,9,20,Regen
14/05/2016 17:00,471,172,299,10,20,Regen
14/05/2016 18:00,464,174,290,9,20,Regen
14/05/2016 19:00,367,165,202,9,20,Regen
14/05/2016 20:00,309,138,171,8,15,teilweise bewölkt
14/05/2016 21:00,190,99,91,7,19,teilweise bewölkt
14/05/2016 22:00,175,96,79,7,17,Regen
14/05/2016 23:00,144,78,66,5,15,teilweise bewölkt
15/05/2016 00:00,143,62,81,5,19,Klarer Himmel
15/05/2016 01:00,128,50,78,5,15,teilweise bewölkt
15/05/2016 02:00,73,38,35,5,13,teilweise bewölkt
15/05/2016 03:00,55,32,23,5,15,teilweise bewölkt
15/05/2016 04:00,55,41,14,4,15,teilweise bewölkt
15/05/2016 05:00,46,27,19,4,15,teilweise bewölkt
15/05/2016 06:00,43,25,18,6,19,teilweise bewölkt
15/05/2016 07:00,55,26,29,7,20,teilweise bewölkt
15/05/2016 08:00,61,32,29,8,22,wolkig
15/05/2016 09:00,114,60,54,9,22,teilweise bewölkt
15/05/2016 10:00,167,84,83,10,26,wolkig
15/05/2016 11:00,201,120,81,8,13,teilweise bewölkt
15/05/2016 12:00,187,94,93,8,15,teilweise bewölkt
15/05/2016 13:00,225,108,117,12,24,teilweise bewölkt
15/05/2016 14:00,222,119,103,10,22,Regen
15/05/2016 15:00,188,100,88,12,28,teilweise bewölkt
15/05/2016 16:00,268,149,119,10,20,Regen
15/05/2016 17:00,230,110,120,9,9,wolkig
15/05/2016 18:00,282,121,161,10,11,wolkig
15/05/2016 19:00,252,135,117,9,22,wolkig
15/05/2016 20:00,211,111,100,8,15,teilweise bewölkt
15/05/2016 21:00,168,90,78,7,11,teilweise bewölkt
15/05/2016 22:00,135,83,52,6,9,Klarer Himmel
15/05/2016 23:00,102,57,45,5,7,Klarer Himmel
16/05/2016 00:00,69,35,34,4,6,Klarer Himmel
16/05/2016 01:00,56,26,30,3,6,Klarer Himmel
16/05/2016 02:00,44,22,22,3,7,Klarer Himmel
16/05/2016 03:00,21,11,10,2,7,Klarer Himmel
16/05/2016 04:00,26,21,5,3,6,Nebel
16/05/2016 05:00,28,19,9,3,6,Nebel
16/05/2016 06:00,34,18,16,3,2,Nebel
16/05/2016 07:00,52,27,25,6,9,teilweise bewölkt
16/05/2016 08:00,72,30,42,8,9,wolkig
16/05/2016 09:00,146,73,73,9,13,wolkig
16/05/2016 10:00,207,105,102,10,15,teilweise bewölkt
16/05/2016 11:00,246,135,111,11,9,teilweise bewölkt
16/05/2016 12:00,279,167,112,11,11,teilweise bewölkt
16/05/2016 13:00,267,146,121,12,13,wolkig
16/05/2016 14:00,357,190,167,12,19,wolkig
16/05/2016 15:00,358,200,158,13,20,wolkig
16/05/2016 16:00,357,166,191,12,22,wolkig
16/05/2016 17:00,367,176,191,12,26,wolkig
16/05/2016 18:00,349,182,167,12,13,teilweise bewölkt
16/05/2016 19:00,291,144,147,11,17,wolkig
16/05/2016 20:00,259,142,117,11,13,wolkig
16/05/2016 21:00,169,102,67,10,17,wolkig
16/05/2016 22:00,162,102,60,9,15,Klarer Himmel
16/05/2016 23:00,102,53,49,9,11,Klarer Himmel
17/05/2016 00:00,45,34,11,9,11,wolkig
17/05/2016 01:00,16,9,7,9,11,wolkig
17/05/2016 02:00,6,3,3,8,11,wolkig
17/05/2016 03:00,6,3,3,8,11,wolkig
17/05/2016 04:00,14,5,9,9,13,wolkig
17/05/2016 05:00,75,40,35,9,11,wolkig
17/05/2016 06:00,251,138,113,9,11,wolkig
17/05/2016 07:00,558,336,222,9,11,wolkig
17/05/2016 08:00,776,514,262,10,11,wolkig
17/05/2016 09:00,585,401,184,11,11,wolkig
17/05/2016 10:00,505,327,178,12,11,teilweise bewölkt
17/05/2016 11:00,577,317,260,14,20,teilweise bewölkt
17/05/2016 12:00,630,325,305,15,19,wolkig
17/05/2016 13:00,631,326,305,15,19,wolkig
17/05/2016 14:00,660,328,332,15,17,teilweise bewölkt
17/05/2016 15:00,712,347,365,17,17,teilweise bewölkt
17/05/2016 16:00,886,371,515,16,17,wolkig
17/05/2016 17:00,1002,466,536,17,26,wolkig
17/05/2016 18:00,909,432,477,16,17,wolkig
17/05/2016 19:00,719,306,413,16,9,teilweise bewölkt
17/05/2016 20:00,456,184,272,15,6,Klarer Himmel
17/05/2016 21:00,313,138,175,12,9,teilweise bewölkt
17/05/2016 22:00,252,130,122,13,6,teilweise bewölkt
17/05/2016 23:00,154,83,71,12,11,Klarer Himmel
18/05/2016 00:00,84,46,38,11,7,Klarer Himmel
18/05/2016 01:00,36,20,16,9,2,Klarer Himmel
18/05/2016 02:00,14,6,8,8,4,teilweise bewölkt
18/05/2016 03:00,13,10,3,10,7,wolkig
18/05/2016 04:00,26,15,11,10,7,teilweise bewölkt
18/05/2016 05:00,100,43,57,10,4,Klarer Himmel
18/05/2016 06:00,368,176,192,10,6,Klarer Himmel
18/05/2016 07:00,974,641,333,11,7,wolkig
18/05/2016 08:00,856,583,273,12,7,wolkig
18/05/2016 09:00,674,481,193,15,15,wolkig
18/05/2016 10:00,616,411,205,16,15,teilweise bewölkt
18/05/2016 11:00,650,337,313,17,17,wolkig
18/05/2016 12:00,733,400,333,18,15,wolkig
18/05/2016 13:00,764,361,403,18,17,wolkig
18/05/2016 14:00,778,332,446,18,13,Regen
18/05/2016 15:00,786,390,396,18,6,wolkig
18/05/2016 16:00,891,407,484,18,9,wolkig
18/05/2016 17:00,1093,491,602,19,15,wolkig
18/05/2016 18:00,895,417,478,16,17,Regen
18/05/2016 19:00,695,295,400,15,9,wolkig
18/05/2016 20:00,464,220,244,15,4,
18/05/2016 21:00,311,141,170,14,6,wolkig
18/05/2016 22:00,245,138,107,14,6,wolkig
18/05/2016 23:00,209,106,103,14,4,wolkig
19/05/2016 00:00,97,47,50,12,4,Regen
19/05/2016 01:00,45,22,23,13,6,wolkig
19/05/2016 02:00,24,4,20,12,6,Klarer Himmel
19/05/2016 03:00,30,10,20,11,2,Klarer Himmel
19/05/2016 04:00,26,12,14,10,2,Klarer Himmel
19/05/2016 05:00,104,52,52,8,2,Nebel
19/05/2016 06:00,339,155,184,9,0,Nebel
19/05/2016 07:00,951,627,324,12,2,Regen
19/05/2016 08:00,843,571,272,13,15,Klarer Himmel
19/05/2016 09:00,651,476,175,13,13,wolkig
19/05/2016 10:00,496,291,205,15,11,wolkig
19/05/2016 11:00,436,230,206,16,11,wolkig
19/05/2016 12:00,677,349,328,17,13,wolkig
19/05/2016 13:00,714,326,388,17,15,wolkig
19/05/2016 14:00,786,399,387,18,20,wolkig
19/05/2016 15:00,839,392,447,18,19,wolkig
19/05/2016 16:00,972,452,520,18,17,teilweise bewölkt
19/05/2016 17:00,1163,529,634,19,19,teilweise bewölkt
19/05/2016 18:00,1096,519,577,18,17,teilweise bewölkt
19/05/2016 19:00,843,372,471,18,15,teilweise bewölkt
19/05/2016 20:00,557,220,337,17,11,Klarer Himmel
19/05/2016 21:00,370,171,199,14,7,Klarer Himmel
19/05/2016 22:00,350,196,154,10,6,Klarer Himmel
19/05/2016 23:00,174,89,85,10,4,Klarer Himmel
20/05/2016 00:00,95,43,52,10,7,Klarer Himmel
20/05/2016 01:00,45,20,25,10,11,Klarer Himmel
20/05/2016 02:00,15,4,11,10,11,Klarer Himmel
20/05/2016 03:00,10,8,2,10,9,Klarer Himmel
20/05/2016 04:00,13,6,7,11,11,Klarer Himmel
20/05/2016 05:00,90,51,39,10,11,Klarer Himmel
20/05/2016 06:00,333,158,175,11,13,Klarer Himmel
20/05/2016 07:00,1001,653,348,12,15,wolkig
20/05/2016 08:00,748,512,236,12,15,Regen
20/05/2016 09:00,575,394,181,12,15,wolkig
20/05/2016 10:00,499,308,191,14,13,Regen
20/05/2016 11:00,588,317,271,14,22,wolkig
20/05/2016 12:00,692,332,360,15,24,wolkig
20/05/2016 13:00,851,353,498,16,20,wolkig
20/05/2016 14:00,877,398,479,14,15,Regen
20/05/2016 15:00,824,390,434,15,20,Regen
20/05/2016 16:00,814,380,434,15,9,wolkig
20/05/2016 17:00,848,356,492,15,13,wolkig
20/05/2016 18:00,697,283,414,15,11,wolkig
20/05/2016 19:00,568,267,301,15,9,wolkig
20/05/2016 20:00,412,219,193,15,9,Klarer Himmel
20/05/2016 21:00,325,146,179,14,9,Klarer Himmel
20/05/2016 22:00,291,120,171,14,9,wolkig
20/05/2016 23:00,198,98,100,14,9,wolkig
21/05/2016 00:00,180,91,89,14,9,Klarer Himmel
21/05/2016 01:00,157,83,74,14,13,wolkig
21/05/2016 02:00,107,57,50,14,13,wolkig
21/05/2016 03:00,70,42,28,12,7,Klarer Himmel
21/05/2016 04:00,71,36,35,12,7,Klarer Himmel
21/05/2016 05:00,61,42,19,11,6,Nebel
21/05/2016 06:00,97,55,42,12,7,
21/05/2016 07:00,185,113,72,14,9,Klarer Himmel
21/05/2016 08:00,315,205,110,15,15,Klarer Himmel
21/05/2016 09:00,577,392,185,17,15,wolkig
21/05/2016 10:00,748,465,283,18,15,wolkig
21/05/2016 11:00,830,526,304,19,17,wolkig
21/05/2016 12:00,946,547,399,20,19,wolkig
21/05/2016 13:00,856,435,421,22,19,wolkig
21/05/2016 14:00,918,445,473,23,19,Klarer Himmel
21/05/2016 15:00,922,510,412,23,22,wolkig
21/05/2016 16:00,707,328,379,22,20,Klarer Himmel
21/05/2016 17:00,769,298,471,23,19,Klarer Himmel
21/05/2016 18:00,846,298,548,23,15,Klarer Himmel
21/05/2016 19:00,696,284,412,22,13,Klarer Himmel
21/05/2016 20:00,417,187,230,20,6,Klarer Himmel
21/05/2016 21:00,263,117,146,19,6,Klarer Himmel
21/05/2016 22:00,260,157,103,17,4,Klarer Himmel
21/05/2016 23:00,405,184,221,18,9,Klarer Himmel
22/05/2016 00:00,249,113,136,18,7,Klarer Himmel
22/05/2016 01:00,260,119,141,17,7,Klarer Himmel
22/05/2016 02:00,171,89,82,16,9,Klarer Himmel
22/05/2016 03:00,108,67,41,15,7,Klarer Himmel
22/05/2016 04:00,106,75,31,14,7,Klarer Himmel
22/05/2016 05:00,45,36,9,14,7,Klarer Himmel
22/05/2016 06:00,47,26,21,15,9,Klarer Himmel
22/05/2016 07:00,56,22,34,17,11,Klarer Himmel
22/05/2016 08:00,98,51,47,19,13,Klarer Himmel
22/05/2016 09:00,205,127,78,21,13,Klarer Himmel
22/05/2016 10:00,263,141,122,23,13,Klarer Himmel
22/05/2016 11:00,310,178,132,24,20,Klarer Himmel
22/05/2016 12:00,369,191,178,23,22,wolkig
22/05/2016 13:00,402,221,181,22,32,wolkig
22/05/2016 14:00,376,206,170,23,24,wolkig
22/05/2016 15:00,431,213,218,22,20,Regen
22/05/2016 16:00,384,202,182,20,22,Klarer Himmel
22/05/2016 17:00,382,194,188,19,17,Regen
22/05/2016 18:00,318,188,130,17,20,Regen
22/05/2016 19:00,263,161,102,16,6,Regen
22/05/2016 20:00,204,115,89,15,4,wolkig
22/05/2016 21:00,170,104,66,15,7,Klarer Himmel
22/05/2016 22:00,155,108,47,15,7,Regen
22/05/2016 23:00,54,32,22,15,7,wolkig
23/05/2016 00:00,49,27,22,15,7,wolkig
23/05/2016 01:00,27,15,12,15,7,wolkig
23/05/2016 02:00,6,0,6,15,4,Regen
23/05/2016 03:00,6,4,2,15,6,Klarer Himmel
23/05/2016 04:00,12,9,3,15,4,Nebel
23/05/2016 05:00,88,40,48,15,6,wolkig
23/05/2016 06:00,322,153,169,15,4,wolkig
23/05/2016 07:00,932,641,291,15,6,wolkig
23/05/2016 08:00,827,569,258,15,11,Regen
23/05/2016 09:00,629,468,161,15,11,Regen
23/05/2016 10:00,492,312,180,16,13,Regen
23/05/2016 11:00,584,332,252,15,17,wolkig
23/05/2016 12:00,632,313,319,15,15,wolkig
23/05/2016 13:00,714,349,365,15,15,wolkig
23/05/2016 14:00,708,341,367,15,13,wolkig
23/05/2016 15:00,867,456,411,15,13,wolkig
23/05/2016 16:00,1019,468,551,15,11,wolkig
23/05/2016 17:00,1072,481,591,15,7,wolkig
23/05/2016 18:00,928,365,563,13,20,Regen
23/05/2016 19:00,682,282,400,12,17,Regen
23/05/2016 20:00,437,199,238,12,17,Regen
23/05/2016 21:00,271,120,151,11,20,wolkig
23/05/2016 22:00,206,100,106,11,17,wolkig
23/05/2016 23:00,123,71,52,11,20,wolkig
24/05/2016 00:00,48,25,23,11,15,wolkig
24/05/2016 01:00,26,14,12,11,17,wolkig
24/05/2016 02:00,11,5,6,10,19,wolkig
24/05/2016 03:00,7,3,4,10,17,wolkig
24/05/2016 04:00,7,4,3,10,15,wolkig
24/05/2016 05:00,77,34,43,10,17,wolkig
24/05/2016 06:00,349,164,185,10,13,wolkig
24/05/2016 07:00,1040,691,349,10,17,wolkig
24/05/2016 08:00,959,678,281,10,15,wolkig
24/05/2016 09:00,688,514,174,11,17,wolkig
24/05/2016 10:00,554,346,208,11,19,wolkig
24/05/2016 11:00,582,335,247,11,15,wolkig
24/05/2016 12:00,668,309,359,12,15,wolkig
24/05/2016 13:00,743,364,379,11,19,Regen
24/05/2016 14:00,731,337,394,11,15,wolkig
24/05/2016 15:00,891,418,473,12,17,wolkig
24/05/2016 16:00,1025,413,612,12,15,Regen
24/05/2016 17:00,1129,510,619,11,17,Regen
24/05/2016 18:00,1042,461,581,11,7,wolkig
24/05/2016 19:00,813,333,480,11,9,wolkig
24/05/2016 20:00,510,241,269,10,9,wolkig
24/05/2016 21:00,386,176,210,10,11,wolkig
24/05/2016 22:00,334,180,154,10,6,wolkig
24/05/2016 23:00,172,84,88,10,7,wolkig
25/05/2016 00:00,76,37,39,10,9,wolkig
25/05/2016 01:00,30,7,23,10,6,wolkig
25/05/2016 02:00,11,7,4,10,6,Regen
25/05/2016 03:00,8,7,1,10,6,wolkig
25/05/2016 04:00,14,6,8,10,9,wolkig
25/05/2016 05:00,92,37,55,10,7,wolkig
25/05/2016 06:00,352,169,183,10,7,wolkig
25/05/2016 07:00,1047,703,344,10,7,wolkig
25/05/2016 08:00,921,603,318,11,7,wolkig
25/05/2016 09:00,801,565,236,11,7,wolkig
25/05/2016 10:00,685,417,268,12,7,wolkig
25/05/2016 11:00,754,408,346,13,9,wolkig
25/05/2016 12:00,839,411,428,13,9,wolkig
25/05/2016 13:00,847,430,417,14,9,wolkig
25/05/2016 14:00,858,383,475,15,11,wolkig
25/05/2016 15:00,924,411,513,15,11,wolkig
25/05/2016 16:00,1024,432,592,16,9,wolkig
25/05/2016 17:00,1157,557,600,16,6,wolkig
25/05/2016 18:00,991,447,544,15,4,wolkig
25/05/2016 19:00,815,343,472,15,4,wolkig
25/05/2016 20:00,608,282,326,14,2,wolkig
25/05/2016 21:00,422,173,249,13,4,wolkig
25/05/2016 22:00,324,163,161,13,2,wolkig
25/05/2016 23:00,306,137,169,13,4,wolkig
26/05/2016 00:00,274,127,147,13,4,wolkig
26/05/2016 01:00,302,116,186,12,6,wolkig
26/05/2016 02:00,257,116,141,11,2,wolkig
26/05/2016 03:00,154,91,63,12,4,wolkig
26/05/2016 04:00,136,95,41,12,4,wolkig
26/05/2016 05:00,103,72,31,12,2,wolkig
26/05/2016 06:00,72,30,42,12,4,wolkig
26/05/2016 07:00,115,43,72,13,4,wolkig
26/05/2016 08:00,176,66,110,15,2,Klarer Himmel
26/05/2016 09:00,208,109,99,17,4,teilweise bewölkt
26/05/2016 10:00,334,185,149,17,4,teilweise bewölkt
26/05/2016 11:00,341,162,179,18,9,teilweise bewölkt
26/05/2016 12:00,370,196,174,19,6,teilweise bewölkt
26/05/2016 13:00,449,214,235,19,6,Klarer Himmel
26/05/2016 14:00,469,242,227,18,9,wolkig
26/05/2016 15:00,519,291,228,18,11,wolkig
26/05/2016 16:00,560,277,283,19,7,wolkig
26/05/2016 17:00,590,278,312,20,6,teilweise bewölkt
26/05/2016 18:00,571,296,275,20,6,teilweise bewölkt
26/05/2016 19:00,555,313,242,19,11,wolkig
26/05/2016 20:00,425,221,204,17,13,Klarer Himmel
26/05/2016 21:00,305,174,131,16,7,Klarer Himmel
26/05/2016 22:00,258,156,102,15,9,Klarer Himmel
26/05/2016 23:00,172,101,71,14,9,
27/05/2016 00:00,101,43,58,14,9,
27/05/2016 01:00,52,22,30,13,11,
27/05/2016 02:00,27,7,20,12,9,
27/05/2016 03:00,13,8,5,12,7,
27/05/2016 04:00,9,4,5,12,9,
27/05/2016 05:00,62,25,37,11,7,
27/05/2016 06:00,194,96,98,13,7,
27/05/2016 07:00,466,298,168,13,11,
27/05/2016 08:00,547,378,169,14,13,
27/05/2016 09:00,583,416,167,15,11,wolkig
27/05/2016 10:00,632,380,252,16,13,wolkig
27/05/2016 11:00,671,402,269,16,15,wolkig
27/05/2016 12:00,792,442,350,16,19,wolkig
27/05/2016 13:00,782,360,422,18,15,wolkig
27/05/2016 14:00,845,397,448,18,13,wolkig
27/05/2016 15:00,791,337,454,19,15,wolkig
27/05/2016 16:00,812,347,465,19,11,wolkig
27/05/2016 17:00,888,386,502,20,13,wolkig
27/05/2016 18:00,767,297,470,21,11,teilweise bewölkt
27/05/2016 19:00,787,264,523,19,11,wolkig
27/05/2016 20:00,643,231,412,19,6,wolkig
27/05/2016 21:00,480,241,239,17,6,teilweise bewölkt
27/05/2016 22:00,401,259,142,15,4,Klarer Himmel
27/05/2016 23:00,395,287,108,14,4,Klarer Himmel
28/05/2016 00:00,303,233,70,14,2,Klarer Himmel
28/05/2016 01:00,203,145,58,14,6,Klarer Himmel
28/05/2016 02:00,118,86,32,14,6,Klarer Himmel
28/05/2016 03:00,68,46,22,14,6,
28/05/2016 04:00,58,42,16,14,2,
28/05/2016 05:00,52,32,20,14,4,
28/05/2016 06:00,63,40,23,15,6,
28/05/2016 07:00,137,83,54,16,4,
28/05/2016 08:00,264,154,110,18,7,teilweise bewölkt
28/05/2016 09:00,475,317,158,20,6,teilweise bewölkt
28/05/2016 10:00,686,436,250,20,13,teilweise bewölkt
28/05/2016 11:00,862,498,364,22,9,teilweise bewölkt
28/05/2016 12:00,858,431,427,22,11,teilweise bewölkt
28/05/2016 13:00,922,417,505,23,7,teilweise bewölkt
28/05/2016 14:00,855,316,539,23,7,teilweise bewölkt
28/05/2016 15:00,733,276,457,22,15,teilweise bewölkt
28/05/2016 16:00,687,273,414,21,20,wolkig
28/05/2016 17:00,699,284,415,21,15,teilweise bewölkt
28/05/2016 18:00,660,282,378,21,9,Regen
28/05/2016 19:00,583,298,285,21,6,wolkig
28/05/2016 20:00,539,256,283,20,6,Klarer Himmel
28/05/2016 21:00,397,203,194,18,6,Klarer Himmel
28/05/2016 22:00,358,216,142,17,7,Klarer Himmel
28/05/2016 23:00,385,243,142,17,6,Klarer Himmel
29/05/2016 00:00,327,223,104,16,7,Klarer Himmel
29/05/2016 01:00,260,199,61,16,6,Klarer Himmel
29/05/2016 02:00,177,151,26,16,7,teilweise bewölkt
29/05/2016 03:00,105,86,19,16,4,Regen
29/05/2016 04:00,85,68,17,16,9,Regen
29/05/2016 05:00,62,48,14,15,7,wolkig
29/05/2016 06:00,32,22,10,16,9,Regen
29/05/2016 07:00,50,25,25,16,13,wolkig
29/05/2016 08:00,76,37,39,16,11,wolkig
29/05/2016 09:00,133,65,68,16,13,Regen
29/05/2016 10:00,164,80,84,17,9,Regen
29/05/2016 11:00,200,120,80,18,20,wolkig
29/05/2016 12:00,249,134,115,17,15,wolkig
29/05/2016 13:00,329,159,170,17,13,wolkig
29/05/2016 14:00,353,169,184,17,13,wolkig
29/05/2016 15:00,385,201,184,17,22,wolkig
29/05/2016 16:00,420,220,200,17,20,wolkig
29/05/2016 17:00,488,268,220,16,17,wolkig
29/05/2016 18:00,446,263,183,16,13,wolkig
29/05/2016 19:00,378,223,155,16,13,wolkig
29/05/2016 20:00,318,183,135,16,9,wolkig
29/05/2016 21:00,224,161,63,16,9,wolkig
29/05/2016 22:00,172,102,70,16,9,wolkig
29/05/2016 23:00,105,67,38,16,7,wolkig
30/05/2016 00:00,36,24,12,16,9,wolkig
30/05/2016 01:00,24,18,6,16,9,wolkig
30/05/2016 02:00,16,13,3,16,17,wolkig
30/05/2016 03:00,6,5,1,16,13,wolkig
30/05/2016 04:00,11,7,4,16,22,wolkig
30/05/2016 05:00,92,43,49,15,7,wolkig
30/05/2016 06:00,332,144,188,15,15,wolkig
30/05/2016 07:00,881,608,273,16,19,wolkig
30/05/2016 08:00,811,598,213,16,11,wolkig
30/05/2016 09:00,679,499,180,17,13,wolkig
30/05/2016 10:00,618,396,222,19,20,wolkig
30/05/2016 11:00,511,279,232,20,11,wolkig
30/05/2016 12:00,666,326,340,22,20,wolkig
30/05/2016 13:00,689,343,346,23,22,wolkig
30/05/2016 14:00,698,332,366,24,22,wolkig
30/05/2016 15:00,806,398,408,24,13,teilweise bewölkt
30/05/2016 16:00,960,435,525,25,13,wolkig
30/05/2016 17:00,1017,477,540,21,13,Regen
30/05/2016 18:00,969,428,541,21,7,Regen
30/05/2016 19:00,535,205,330,19,11,Gewitter
30/05/2016 20:00,467,199,268,19,6,wolkig
30/05/2016 21:00,291,149,142,18,7,teilweise bewölkt
30/05/2016 22:00,242,100,142,18,7,teilweise bewölkt
30/05/2016 23:00,115,57,58,17,6,Klarer Himmel
31/05/2016 00:00,44,23,21,16,4,Klarer Himmel
31/05/2016 01:00,38,10,28,16,6,Klarer Himmel
31/05/2016 02:00,13,5,8,15,6,Klarer Himmel
31/05/2016 03:00,3,1,2,15,4,Klarer Himmel
31/05/2016 04:00,13,6,7,14,6,teilweise bewölkt
31/05/2016 05:00,97,47,50,14,4,Nebel
31/05/2016 06:00,370,176,194,15,6,teilweise bewölkt
31/05/2016 07:00,1138,759,379,17,7,teilweise bewölkt
31/05/2016 08:00,1037,721,316,18,7,teilweise bewölkt
31/05/2016 09:00,811,575,236,20,9,teilweise bewölkt
31/05/2016 10:00,665,415,250,20,11,teilweise bewölkt
31/05/2016 11:00,613,370,243,19,13,wolkig
31/05/2016 12:00,730,337,393,20,11,wolkig
31/05/2016 13:00,808,383,425,21,13,wolkig
31/05/2016 14:00,854,442,412,22,7,wolkig
31/05/2016 15:00,953,465,488,23,7,wolkig
31/05/2016 16:00,1138,506,632,23,7,Klarer Himmel
31/05/2016 17:00,1216,568,648,23,7,Klarer Himmel
31/05/2016 18:00,1111,490,621,24,7,Klarer Himmel
31/05/2016 19:00,949,434,515,23,4,Klarer Himmel
31/05/2016 20:00,610,250,360,23,2,Klarer Himmel
31/05/2016 21:00,453,224,229,21,6,Klarer Himmel
31/05/2016 22:00,372,197,175,21,6,Klarer Himmel
31/05/2016 23:00,200,95,105,19,7,Klarer Himmel
01/06/2016 00:00,83,42,41,18,6,wolkig
01/06/2016 01:00,55,29,26,17,4,Gewitter
01/06/2016 02:00,11,4,7,16,9,wolkig
01/06/2016 03:00,14,7,7,16,6,Klarer Himmel
01/06/2016 04:00,21,11,10,15,0,Nebel
01/06/2016 05:00,97,46,51,16,4,wolkig
01/06/2016 06:00,321,140,181,16,6,wolkig
01/06/2016 07:00,1019,686,333,17,6,wolkig
01/06/2016 08:00,902,656,246,18,6,wolkig
01/06/2016 09:00,706,516,190,19,7,wolkig
01/06/2016 10:00,623,371,252,19,13,wolkig
01/06/2016 11:00,693,409,284,19,11,Regen
01/06/2016 12:00,668,345,323,20,9,wolkig
01/06/2016 13:00,746,338,408,21,9,wolkig
01/06/2016 14:00,758,336,422,22,17,wolkig
01/06/2016 15:00,792,368,424,23,11,wolkig
01/06/2016 16:00,1036,441,595,21,6,wolkig
01/06/2016 17:00,1051,446,605,20,11,Regen
01/06/2016 18:00,821,346,475,19,7,Gewitter
01/06/2016 19:00,665,277,388,19,6,Regen
01/06/2016 20:00,484,209,275,19,7,wolkig
01/06/2016 21:00,342,161,181,18,2,Regen
01/06/2016 22:00,272,131,141,18,9,Regen
01/06/2016 23:00,190,79,111,18,9,wolkig
02/06/2016 00:00,149,52,97,18,4,wolkig
02/06/2016 01:00,81,28,53,19,11,wolkig
02/06/2016 02:00,60,41,19,18,11,wolkig
02/06/2016 03:00,34,28,6,18,7,wolkig
02/06/2016 04:00,41,26,15,17,6,teilweise bewölkt
02/06/2016 05:00,89,42,47,16,7,teilweise bewölkt
02/06/2016 06:00,338,150,188,17,6,teilweise bewölkt
02/06/2016 07:00,1040,698,342,18,7,
02/06/2016 08:00,880,610,270,19,6,teilweise bewölkt
02/06/2016 09:00,774,570,204,19,7,teilweise bewölkt
02/06/2016 10:00,655,431,224,20,9,wolkig
02/06/2016 11:00,690,386,304,21,11,wolkig
02/06/2016 12:00,752,344,408,22,7,teilweise bewölkt
02/06/2016 13:00,826,376,450,22,6,teilweise bewölkt
02/06/2016 14:00,790,356,434,24,7,teilweise bewölkt
02/06/2016 15:00,962,452,510,18,22,Gewitter
02/06/2016 16:00,610,227,383,16,7,Regen
02/06/2016 17:00,855,412,443,16,6,wolkig
02/06/2016 18:00,936,413,523,17,7,wolkig
02/06/2016 19:00,782,374,408,17,9,teilweise bewölkt
02/06/2016 20:00,501,220,281,18,7,Klarer Himmel
02/06/2016 21:00,395,182,213,16,6,Nebel
02/06/2016 22:00,323,168,155,16,4,Nebel
02/06/2016 23:00,250,114,136,16,2,Nebel
03/06/2016 00:00,129,51,78,15,4,Nebel
03/06/2016 01:00,60,32,28,16,4,Nebel
03/06/2016 02:00,33,20,13,17,6,Nebel
03/06/2016 03:00,32,16,16,16,6,Nebel
03/06/2016 04:00,29,18,11,16,4,wolkig
03/06/2016 05:00,92,44,48,16,2,Nebel
03/06/2016 06:00,313,142,171,16,2,Nebel
03/06/2016 07:00,932,635,297,15,6,wolkig
03/06/2016 08:00,776,548,228,15,6,Nebel
03/06/2016 09:00,626,439,187,16,4,wolkig
03/06/2016 10:00,603,382,221,17,2,wolkig
03/06/2016 11:00,649,359,290,20,4,wolkig
03/06/2016 12:00,757,352,405,22,7,wolkig
03/06/2016 13:00,923,408,515,23,7,wolkig
03/06/2016 14:00,858,394,464,24,13,teilweise bewölkt
03/06/2016 15:00,809,392,417,25,13,teilweise bewölkt
03/06/2016 16:00,887,372,515,25,17,Klarer Himmel
03/06/2016 17:00,895,421,474,25,13,Klarer Himmel
03/06/2016 18:00,893,418,475,26,11,Klarer Himmel
03/06/2016 19:00,796,371,425,25,13,Klarer Himmel
03/06/2016 20:00,570,283,287,22,6,teilweise bewölkt
03/06/2016 21:00,441,208,233,20,7,Klarer Himmel
03/06/2016 22:00,390,182,208,18,6,Klarer Himmel
03/06/2016 23:00,302,151,151,18,7,Klarer Himmel
04/06/2016 00:00,235,100,135,17,4,Klarer Himmel
04/06/2016 01:00,212,71,141,17,4,Klarer Himmel
04/06/2016 02:00,139,58,81,17,6,Klarer Himmel
04/06/2016 03:00,92,48,44,15,4,Nebel
04/06/2016 04:00,63,38,25,15,7,Nebel
04/06/2016 05:00,68,47,21,15,4,Nebel
04/06/2016 06:00,74,42,32,16,0,Nebel
04/06/2016 07:00,176,110,66,19,4,Klarer Himmel
04/06/2016 08:00,300,185,115,21,7,Klarer Himmel
04/06/2016 09:00,531,337,194,24,11,Klarer Himmel
04/06/2016 10:00,700,445,255,25,15,Klarer Himmel
04/06/2016 11:00,797,482,315,25,19,teilweise bewölkt
04/06/2016 12:00,881,496,385,25,15,wolkig
04/06/2016 13:00,864,443,421,26,17,wolkig
04/06/2016 14:00,983,493,490,27,17,wolkig
04/06/2016 15:00,815,425,390,26,20,teilweise bewölkt
04/06/2016 16:00,746,343,403,26,22,teilweise bewölkt
04/06/2016 17:00,804,328,476,26,13,wolkig
04/06/2016 18:00,910,352,558,25,17,wolkig
04/06/2016 19:00,752,362,390,24,9,wolkig
04/06/2016 20:00,481,241,240,22,6,teilweise bewölkt
04/06/2016 21:00,392,182,210,20,7,teilweise bewölkt
04/06/2016 22:00,414,203,211,19,9,Klarer Himmel
04/06/2016 23:00,306,135,171,18,7,Klarer Himmel
05/06/2016 00:00,322,176,146,18,6,Klarer Himmel
05/06/2016 01:00,253,114,139,18,2,Klarer Himmel
05/06/2016 02:00,181,97,84,16,4,Klarer Himmel
05/06/2016 03:00,137,77,60,15,4,Klarer Himmel
05/06/2016 04:00,70,45,25,15,2,Nebel
05/06/2016 05:00,44,29,15,15,4,Nebel
05/06/2016 06:00,55,35,20,17,2,Klarer Himmel
05/06/2016 07:00,63,29,34,19,4,Klarer Himmel
05/06/2016 08:00,100,46,54,21,7,Klarer Himmel
05/06/2016 09:00,205,125,80,23,6,Klarer Himmel
05/06/2016 10:00,322,163,159,24,13,Klarer Himmel
05/06/2016 11:00,323,189,134,25,13,Klarer Himmel
05/06/2016 12:00,424,209,215,26,13,teilweise bewölkt
05/06/2016 13:00,565,284,281,27,15,Klarer Himmel
05/06/2016 14:00,559,270,289,27,17,Klarer Himmel
05/06/2016 15:00,543,283,260,27,13,teilweise bewölkt
05/06/2016 16:00,532,280,252,27,15,teilweise bewölkt
05/06/2016 17:00,606,328,278,28,15,teilweise bewölkt
05/06/2016 18:00,608,341,267,27,15,teilweise bewölkt
05/06/2016 19:00,563,303,260,26,13,Klarer Himmel
05/06/2016 20:00,428,271,157,24,13,Klarer Himmel
05/06/2016 21:00,328,186,142,22,15,Klarer Himmel
05/06/2016 22:00,267,165,102,21,13,Klarer Himmel
05/06/2016 23:00,153,93,60,19,9,Klarer Himmel
06/06/2016 00:00,66,41,25,18,7,Klarer Himmel
06/06/2016 01:00,17,10,7,17,6,Klarer Himmel
06/06/2016 02:00,13,8,5,15,6,Klarer Himmel
06/06/2016 03:00,4,1,3,14,7,Klarer Himmel
06/06/2016 04:00,16,9,7,14,9,
06/06/2016 05:00,99,52,47,14,11,wolkig
06/06/2016 06:00,370,180,190,14,11,wolkig
06/06/2016 07:00,998,668,330,14,11,wolkig
06/06/2016 08:00,953,689,264,15,9,wolkig
06/06/2016 09:00,766,553,213,16,11,wolkig
06/06/2016 10:00,657,420,237,17,7,wolkig
06/06/2016 11:00,674,408,266,19,9,teilweise bewölkt
06/06/2016 12:00,799,375,424,20,9,teilweise bewölkt
06/06/2016 13:00,852,424,428,23,9,teilweise bewölkt
06/06/2016 14:00,849,398,451,24,13,
06/06/2016 15:00,1006,455,551,25,11,
06/06/2016 16:00,1163,492,671,26,11,teilweise bewölkt
06/06/2016 17:00,1237,605,632,26,9,teilweise bewölkt
06/06/2016 18:00,1122,499,623,26,11,teilweise bewölkt
06/06/2016 19:00,959,430,529,26,9,wolkig
06/06/2016 20:00,634,281,353,24,7,wolkig
06/06/2016 21:00,507,222,285,22,7,wolkig
06/06/2016 22:00,347,148,199,20,6,Klarer Himmel
06/06/2016 23:00,188,103,85,19,4,Klarer Himmel
07/06/2016 00:00,112,60,52,18,4,
07/06/2016 01:00,49,30,19,17,4,
07/06/2016 02:00,19,7,12,16,4,
07/06/2016 03:00,18,9,9,16,4,Nebel
07/06/2016 04:00,13,5,8,16,0,Nebel
07/06/2016 05:00,107,58,49,15,4,Nebel
07/06/2016 06:00,417,196,221,16,2,
07/06/2016 07:00,1112,750,362,18,4,
07/06/2016 08:00,1082,762,320,21,4,Klarer Himmel
07/06/2016 09:00,838,594,244,23,2,Klarer Himmel
07/06/2016 10:00,665,424,241,25,4,Klarer Himmel
07/06/2016 11:00,672,380,292,26,6,Klarer Himmel
07/06/2016 12:00,817,394,423,27,6,wolkig
07/06/2016 13:00,856,409,447,27,9,wolkig
07/06/2016 14:00,918,416,502,28,11,teilweise bewölkt
07/06/2016 15:00,1035,445,590,22,9,wolkig
07/06/2016 16:00,586,195,391,18,15,Gewitter
07/06/2016 17:00,1036,449,587,20,9,wolkig
07/06/2016 18:00,886,387,499,20,15,wolkig
07/06/2016 19:00,745,337,408,20,4,wolkig
07/06/2016 20:00,430,178,252,19,4,teilweise bewölkt
07/06/2016 21:00,344,165,179,18,6,Nebel
07/06/2016 22:00,288,140,148,16,6,Nebel
07/06/2016 23:00,186,99,87,16,2,Nebel
08/06/2016 00:00,75,37,38,15,4,Nebel
08/06/2016 01:00,35,18,17,15,4,Nebel
08/06/2016 02:00,19,9,10,14,2,Nebel
08/06/2016 03:00,6,2,4,13,4,Nebel
08/06/2016 04:00,20,10,10,13,6,Klarer Himmel
08/06/2016 05:00,97,48,49,13,7,Klarer Himmel
08/06/2016 06:00,383,182,201,13,7,Klarer Himmel
08/06/2016 07:00,1117,754,363,14,9,Klarer Himmel
08/06/2016 08:00,935,660,275,15,13,wolkig
08/06/2016 09:00,864,619,245,16,11,wolkig
08/06/2016 10:00,733,486,247,17,9,wolkig
08/06/2016 11:00,776,449,327,18,13,wolkig
08/06/2016 12:00,858,428,430,18,13,wolkig
08/06/2016 13:00,911,429,482,19,17,wolkig
08/06/2016 14:00,875,378,497,20,13,wolkig
08/06/2016 15:00,931,415,516,21,15,wolkig
08/06/2016 16:00,1137,498,639,21,20,wolkig
08/06/2016 17:00,1317,619,698,19,24,wolkig
08/06/2016 18:00,1189,555,634,17,20,wolkig
08/06/2016 19:00,1038,448,590,17,15,wolkig
08/06/2016 20:00,658,285,373,17,15,Klarer Himmel
08/06/2016 21:00,507,216,291,15,7,Klarer Himmel
08/06/2016 22:00,419,192,227,14,11,Klarer Himmel
08/06/2016 23:00,284,145,139,13,11,Klarer Himmel
09/06/2016 00:00,178,78,100,12,13,teilweise bewölkt
09/06/2016 01:00,114,35,79,12,11,wolkig
09/06/2016 02:00,68,34,34,12,11,wolkig
09/06/2016 03:00,46,37,9,12,11,wolkig
09/06/2016 04:00,40,32,8,12,9,wolkig
09/06/2016 05:00,112,61,51,12,7,wolkig
09/06/2016 06:00,375,166,209,12,13,wolkig
09/06/2016 07:00,1073,745,328,12,9,wolkig
09/06/2016 08:00,925,626,299,12,13,wolkig
09/06/2016 09:00,681,491,190,13,13,Regen
09/06/2016 10:00,612,409,203,13,13,wolkig
09/06/2016 11:00,618,359,259,13,13,wolkig
09/06/2016 12:00,711,334,377,14,13,wolkig
09/06/2016 13:00,823,379,444,15,11,wolkig
09/06/2016 14:00,751,373,378,16,11,wolkig
09/06/2016 15:00,974,454,520,17,13,wolkig
09/06/2016 16:00,1089,463,626,18,15,wolkig
09/06/2016 17:00,1235,567,668,19,13,wolkig
09/06/2016 18:00,1144,519,625,19,11,teilweise bewölkt
09/06/2016 19:00,912,423,489,18,7,teilweise bewölkt
09/06/2016 20:00,578,227,351,18,6,teilweise bewölkt
09/06/2016 21:00,472,217,255,14,0,Klarer Himmel
09/06/2016 22:00,368,171,197,13,6,Klarer Himmel
09/06/2016 23:00,226,137,89,12,11,Klarer Himmel
10/06/2016 00:00,111,68,43,11,11,Klarer Himmel
10/06/2016 01:00,44,18,26,10,6,Klarer Himmel
10/06/2016 02:00,31,14,17,9,6,Klarer Himmel
10/06/2016 03:00,18,12,6,9,4,Klarer Himmel
10/06/2016 04:00,19,12,7,9,6,Klarer Himmel
10/06/2016 05:00,100,57,43,9,4,Nebel
10/06/2016 06:00,342,155,187,9,6,
10/06/2016 07:00,1028,700,328,11,7,teilweise bewölkt
10/06/2016 08:00,849,588,261,13,7,teilweise bewölkt
10/06/2016 09:00,735,505,230,14,6,teilweise bewölkt
10/06/2016 10:00,653,387,266,16,7,teilweise bewölkt
10/06/2016 11:00,700,406,294,17,7,teilweise bewölkt
10/06/2016 12:00,855,410,445,18,9,Klarer Himmel
10/06/2016 13:00,1016,460,556,19,11,Klarer Himmel
10/06/2016 14:00,1007,425,582,20,11,Klarer Himmel
10/06/2016 15:00,978,444,534,20,11,wolkig
10/06/2016 16:00,961,426,535,21,17,wolkig
10/06/2016 17:00,978,452,526,21,13,wolkig
10/06/2016 18:00,855,350,505,21,11,wolkig
10/06/2016 19:00,781,335,446,20,11,wolkig
10/06/2016 20:00,567,260,307,18,13,wolkig
10/06/2016 21:00,387,205,182,17,9,Klarer Himmel
10/06/2016 22:00,324,146,178,16,11,Klarer Himmel
10/06/2016 23:00,315,124,191,15,7,Klarer Himmel
11/06/2016 00:00,237,121,116,14,9,Klarer Himmel
11/06/2016 01:00,200,93,107,12,4,Klarer Himmel
11/06/2016 02:00,101,59,42,12,6,Klarer Himmel
11/06/2016 03:00,91,48,43,12,6,Klarer Himmel
11/06/2016 04:00,70,39,31,12,6,Klarer Himmel
11/06/2016 05:00,60,38,22,12,6,Klarer Himmel
11/06/2016 06:00,72,36,36,12,4,Klarer Himmel
11/06/2016 07:00,164,106,58,13,7,Klarer Himmel
11/06/2016 08:00,255,146,109,14,6,Regen
11/06/2016 09:00,448,320,128,15,4,Regen
11/06/2016 10:00,568,381,187,16,6,Regen
11/06/2016 11:00,645,383,262,17,6,Regen
11/06/2016 12:00,784,456,328,18,4,wolkig
11/06/2016 13:00,773,367,406,20,4,wolkig
11/06/2016 14:00,693,342,351,20,6,wolkig
11/06/2016 15:00,703,314,389,21,7,wolkig
11/06/2016 16:00,630,290,340,21,11,wolkig
11/06/2016 17:00,616,253,363,21,9,wolkig
11/06/2016 18:00,684,274,410,21,7,Klarer Himmel
11/06/2016 19:00,571,234,337,20,11,Klarer Himmel
11/06/2016 20:00,467,208,259,19,6,Klarer Himmel
11/06/2016 21:00,345,191,154,18,4,Klarer Himmel
11/06/2016 22:00,250,127,123,17,4,Klarer Himmel
11/06/2016 23:00,284,159,125,14,2,Klarer Himmel
12/06/2016 00:00,275,154,121,14,0,Klarer Himmel
12/06/2016 01:00,212,103,109,13,2,Klarer Himmel
12/06/2016 02:00,136,55,81,12,0,Klarer Himmel
12/06/2016 03:00,130,82,48,12,0,Klarer Himmel
12/06/2016 04:00,88,52,36,12,0,Klarer Himmel
12/06/2016 05:00,45,33,12,12,0,Klarer Himmel
12/06/2016 06:00,42,20,22,13,0,Klarer Himmel
12/06/2016 07:00,60,27,33,16,0,Klarer Himmel
12/06/2016 08:00,116,56,60,17,0,wolkig
12/06/2016 09:00,197,132,65,18,0,wolkig
12/06/2016 10:00,286,147,139,20,4,wolkig
12/06/2016 11:00,280,163,117,19,9,wolkig
12/06/2016 12:00,361,174,187,19,9,wolkig
12/06/2016 13:00,396,215,181,20,9,wolkig
12/06/2016 14:00,433,245,188,22,6,wolkig
12/06/2016 15:00,392,230,162,20,9,Regen
12/06/2016 16:00,220,110,110,19,6,wolkig
12/06/2016 17:00,302,137,165,18,15,Regen
12/06/2016 18:00,331,184,147,17,13,Regen
12/06/2016 19:00,381,206,175,15,6,Regen
12/06/2016 20:00,476,286,190,15,6,wolkig
12/06/2016 21:00,114,71,43,15,6,wolkig
12/06/2016 22:00,120,73,47,15,4,wolkig
12/06/2016 23:00,492,239,253,14,4,wolkig
13/06/2016 00:00,77,53,24,14,0,wolkig
13/06/2016 01:00,22,12,10,14,2,Regen
13/06/2016 02:00,8,1,7,14,4,wolkig
13/06/2016 03:00,6,2,4,15,6,Regen
13/06/2016 04:00,8,4,4,14,6,Regen
13/06/2016 05:00,76,41,35,14,4,Regen
13/06/2016 06:00,221,106,115,14,6,Regen
13/06/2016 07:00,780,507,273,15,6,Regen
13/06/2016 08:00,822,589,233,15,9,wolkig
13/06/2016 09:00,606,436,170,16,11,wolkig
13/06/2016 10:00,396,254,142,16,11,wolkig
13/06/2016 11:00,465,284,181,17,9,Regen
13/06/2016 12:00,590,304,286,18,11,wolkig
13/06/2016 13:00,612,297,315,19,7,wolkig
13/06/2016 14:00,627,309,318,15,11,Gewitter
13/06/2016 15:00,686,335,351,17,2,wolkig
13/06/2016 16:00,869,388,481,18,11,wolkig
13/06/2016 17:00,952,424,528,19,13,Regen
13/06/2016 18:00,899,410,489,19,11,wolkig
13/06/2016 19:00,643,240,403,19,19,teilweise bewölkt
13/06/2016 20:00,497,210,287,17,13,wolkig
13/06/2016 21:00,325,164,161,16,13,wolkig
13/06/2016 22:00,188,70,118,15,11,wolkig
13/06/2016 23:00,176,80,96,15,9,wolkig
14/06/2016 00:00,65,34,31,15,11,wolkig
14/06/2016 01:00,29,13,16,15,13,wolkig
14/06/2016 02:00,19,6,13,14,9,wolkig
14/06/2016 03:00,15,7,8,14,6,wolkig
14/06/2016 04:00,11,6,5,14,6,wolkig
14/06/2016 05:00,78,35,43,14,6,wolkig
14/06/2016 06:00,263,124,139,14,7,wolkig
14/06/2016 07:00,753,503,250,14,9,Regen
14/06/2016 08:00,828,589,239,14,9,wolkig
14/06/2016 09:00,633,459,174,16,13,wolkig
14/06/2016 10:00,554,354,200,15,13,wolkig
14/06/2016 11:00,523,300,223,16,15,wolkig
14/06/2016 12:00,612,301,311,17,15,wolkig
14/06/2016 13:00,770,385,385,17,17,Regen
14/06/2016 14:00,695,342,353,18,17,wolkig
14/06/2016 15:00,815,393,422,18,17,teilweise bewölkt
14/06/2016 16:00,921,424,497,19,9,teilweise bewölkt
14/06/2016 17:00,1025,472,553,19,11,wolkig
14/06/2016 18:00,970,420,550,20,17,wolkig
14/06/2016 19:00,796,350,446,19,9,wolkig
14/06/2016 20:00,597,248,349,17,7,wolkig
14/06/2016 21:00,396,170,226,15,6,wolkig
14/06/2016 22:00,295,155,140,15,11,wolkig
14/06/2016 23:00,188,115,73,14,4,teilweise bewölkt
15/06/2016 00:00,56,27,29,13,6,teilweise bewölkt
15/06/2016 01:00,48,22,26,13,6,Nebel
15/06/2016 02:00,12,3,9,13,2,Nebel
15/06/2016 03:00,11,5,6,13,4,Nebel
15/06/2016 04:00,21,10,11,13,4,
15/06/2016 05:00,94,45,49,13,6,
15/06/2016 06:00,345,151,194,13,7,Klarer Himmel
15/06/2016 07:00,1013,668,345,14,4,wolkig
15/06/2016 08:00,907,641,266,14,4,wolkig
15/06/2016 09:00,758,531,227,15,7,wolkig
15/06/2016 10:00,663,433,230,16,9,wolkig
15/06/2016 11:00,607,324,283,17,6,Regen
15/06/2016 12:00,615,303,312,13,9,Regen
15/06/2016 13:00,761,349,412,15,6,Regen
15/06/2016 14:00,660,289,371,17,4,Regen
15/06/2016 15:00,799,350,449,18,7,wolkig
15/06/2016 16:00,907,388,519,18,11,wolkig
15/06/2016 17:00,1060,492,568,18,11,Regen
15/06/2016 18:00,911,404,507,17,13,wolkig
15/06/2016 19:00,752,322,430,17,7,wolkig
15/06/2016 20:00,541,261,280,16,11,wolkig
15/06/2016 21:00,361,160,201,15,9,wolkig
15/06/2016 22:00,284,146,138,14,4,wolkig
15/06/2016 23:00,223,112,111,14,6,Klarer Himmel
16/06/2016 00:00,125,63,62,13,6,Klarer Himmel
16/06/2016 01:00,69,35,34,13,6,Klarer Himmel
16/06/2016 02:00,33,11,22,13,7,Klarer Himmel
16/06/2016 03:00,32,11,21,12,4,Klarer Himmel
16/06/2016 04:00,36,10,26,10,4,Nebel
16/06/2016 05:00,104,41,63,10,6,Nebel
16/06/2016 06:00,343,138,205,12,7,Nebel
16/06/2016 07:00,1019,673,346,12,9,wolkig
16/06/2016 08:00,909,643,266,15,4,wolkig
16/06/2016 09:00,811,595,216,17,4,teilweise bewölkt
16/06/2016 10:00,672,376,296,18,4,wolkig
16/06/2016 11:00,662,375,287,19,6,wolkig
16/06/2016 12:00,777,353,424,19,7,wolkig
16/06/2016 13:00,835,403,432,20,7,wolkig
16/06/2016 14:00,876,426,450,20,4,wolkig
16/06/2016 15:00,918,414,504,20,4,wolkig
16/06/2016 16:00,1011,427,584,20,6,Regen
16/06/2016 17:00,1101,499,602,20,7,Gewitter
16/06/2016 18:00,943,415,528,17,13,Regen
16/06/2016 19:00,867,395,472,17,11,Regen
16/06/2016 20:00,773,411,362,16,7,wolkig
16/06/2016 21:00,226,108,118,15,6,wolkig
16/06/2016 22:00,181,95,86,14,4,Klarer Himmel
16/06/2016 23:00,667,309,358,13,2,Klarer Himmel
17/06/2016 00:00,147,74,73,13,2,wolkig
17/06/2016 01:00,53,18,35,14,2,wolkig
17/06/2016 02:00,39,19,20,14,0,wolkig
17/06/2016 03:00,19,8,11,14,2,wolkig
17/06/2016 04:00,20,10,10,14,4,Regen
17/06/2016 05:00,85,44,41,13,4,Nebel
17/06/2016 06:00,280,114,166,14,4,wolkig
17/06/2016 07:00,869,594,275,15,7,teilweise bewölkt
17/06/2016 08:00,753,523,230,15,11,wolkig
17/06/2016 09:00,605,425,180,16,9,teilweise bewölkt
17/06/2016 10:00,392,234,158,15,13,Regen
17/06/2016 11:00,532,301,231,15,11,Regen
17/06/2016 12:00,607,282,325,15,13,Regen
17/06/2016 13:00,838,363,475,16,9,Regen
17/06/2016 14:00,785,360,425,16,11,wolkig
17/06/2016 15:00,767,354,413,16,15,wolkig
17/06/2016 16:00,674,287,387,17,15,wolkig
17/06/2016 17:00,852,400,452,18,17,teilweise bewölkt
17/06/2016 18:00,726,310,416,17,11,Regen
17/06/2016 19:00,619,252,367,17,13,Klarer Himmel
17/06/2016 20:00,426,200,226,17,7,Klarer Himmel
17/06/2016 21:00,285,145,140,16,7,wolkig
17/06/2016 22:00,295,139,156,15,7,Klarer Himmel
17/06/2016 23:00,231,119,112,14,6,Klarer Himmel
18/06/2016 00:00,184,91,93,15,7,Klarer Himmel
18/06/2016 01:00,140,60,80,13,6,wolkig
18/06/2016 02:00,67,31,36,14,7,teilweise bewölkt
18/06/2016 03:00,68,39,29,14,7,wolkig
18/06/2016 04:00,60,38,22,14,6,wolkig
18/06/2016 05:00,60,36,24,13,7,wolkig
18/06/2016 06:00,93,54,39,13,4,Regen
18/06/2016 07:00,179,104,75,14,7,Regen
18/06/2016 08:00,253,151,102,15,6,wolkig
18/06/2016 09:00,410,281,129,15,4,wolkig
18/06/2016 10:00,523,346,177,16,6,wolkig
18/06/2016 11:00,628,412,216,16,9,Regen
18/06/2016 12:00,574,309,265,15,9,wolkig
18/06/2016 13:00,611,297,314,16,15,Regen
18/06/2016 14:00,589,282,307,16,13,Regen
18/06/2016 15:00,584,265,319,18,9,wolkig
18/06/2016 16:00,596,275,321,18,9,Regen
18/06/2016 17:00,423,150,273,15,9,wolkig
18/06/2016 18:00,478,180,298,15,9,wolkig
18/06/2016 19:00,383,162,221,16,11,wolkig
18/06/2016 20:00,309,139,170,15,13,Regen
18/06/2016 21:00,266,142,124,14,9,wolkig
18/06/2016 22:00,182,105,77,14,15,wolkig
18/06/2016 23:00,208,103,105,14,11,wolkig
19/06/2016 00:00,166,73,93,14,11,Regen
19/06/2016 01:00,144,65,79,13,7,Regen
19/06/2016 02:00,106,52,54,13,11,wolkig
19/06/2016 03:00,59,34,25,12,15,Regen
19/06/2016 04:00,70,46,24,12,9,wolkig
19/06/2016 05:00,42,26,16,12,11,wolkig
19/06/2016 06:00,36,20,16,12,9,wolkig
19/06/2016 07:00,55,24,31,12,13,wolkig
19/06/2016 08:00,76,32,44,13,11,wolkig
19/06/2016 09:00,208,125,83,14,9,teilweise bewölkt
19/06/2016 10:00,236,136,100,14,13,wolkig
19/06/2016 11:00,267,151,116,14,13,wolkig
19/06/2016 12:00,316,163,153,14,13,Regen
19/06/2016 13:00,362,207,155,17,7,teilweise bewölkt
19/06/2016 14:00,403,205,198,16,15,wolkig
19/06/2016 15:00,442,234,208,18,9,teilweise bewölkt
19/06/2016 16:00,446,205,241,18,13,teilweise bewölkt
19/06/2016 17:00,487,253,234,18,7,teilweise bewölkt
19/06/2016 18:00,485,236,249,18,7,teilweise bewölkt
19/06/2016 19:00,396,216,180,17,6,teilweise bewölkt
19/06/2016 20:00,383,215,168,16,6,teilweise bewölkt
19/06/2016 21:00,231,140,91,14,9,teilweise bewölkt
19/06/2016 22:00,176,119,57,11,4,Klarer Himmel
19/06/2016 23:00,129,76,53,11,4,Klarer Himmel
20/06/2016 00:00,66,47,19,10,4,Klarer Himmel
20/06/2016 01:00,24,13,11,9,2,Nebel
20/06/2016 02:00,14,6,8,9,4,Nebel
20/06/2016 03:00,4,3,1,9,4,Nebel
20/06/2016 04:00,17,8,9,9,7,teilweise bewölkt
20/06/2016 05:00,100,51,49,9,6,teilweise bewölkt
20/06/2016 06:00,337,152,185,10,11,Klarer Himmel
20/06/2016 07:00,968,657,311,13,11,Klarer Himmel
20/06/2016 08:00,905,612,293,16,19,wolkig
20/06/2016 09:00,737,519,218,18,22,wolkig
20/06/2016 10:00,687,459,228,19,22,wolkig
20/06/2016 11:00,688,400,288,19,26,wolkig
20/06/2016 12:00,734,356,378,20,26,wolkig
20/06/2016 13:00,825,440,385,19,22,Regen
20/06/2016 14:00,795,391,404,20,15,Regen
20/06/2016 15:00,846,405,441,20,19,Regen
20/06/2016 16:00,924,412,512,19,13,Regen
20/06/2016 17:00,1027,440,587,18,11,Regen
20/06/2016 18:00,778,317,461,17,15,Regen
20/06/2016 19:00,518,206,312,16,13,Regen
20/06/2016 20:00,362,147,215,16,20,Regen
20/06/2016 21:00,232,101,131,15,17,Regen
20/06/2016 22:00,193,88,105,15,17,Regen
20/06/2016 23:00,130,75,55,15,15,Regen
21/06/2016 00:00,58,28,30,16,17,wolkig
21/06/2016 01:00,27,17,10,16,19,wolkig
21/06/2016 02:00,14,3,11,15,11,wolkig
21/06/2016 03:00,9,3,6,15,13,wolkig
21/06/2016 04:00,12,9,3,15,9,wolkig
21/06/2016 05:00,89,48,41,15,9,wolkig
21/06/2016 06:00,320,143,177,16,9,Regen
21/06/2016 07:00,934,636,298,16,13,wolkig
21/06/2016 08:00,854,606,248,17,17,wolkig
21/06/2016 09:00,681,499,182,17,13,wolkig
21/06/2016 10:00,576,369,207,17,15,wolkig
21/06/2016 11:00,549,310,239,18,13,wolkig
21/06/2016 12:00,650,314,336,19,15,wolkig
21/06/2016 13:00,745,363,382,19,13,wolkig
21/06/2016 14:00,775,366,409,19,13,wolkig
21/06/2016 15:00,905,416,489,20,9,wolkig
21/06/2016 16:00,1144,517,627,21,7,wolkig
21/06/2016 17:00,1532,720,812,21,11,Regen
21/06/2016 18:00,552,222,330,20,11,Regen
21/06/2016 19:00,346,164,182,20,7,wolkig
21/06/2016 20:00,752,339,413,19,4,wolkig
21/06/2016 21:00,375,188,187,19,2,wolkig
21/06/2016 22:00,273,136,137,18,7,wolkig
21/06/2016 23:00,180,83,97,18,9,wolkig
22/06/2016 00:00,111,52,59,18,7,wolkig
22/06/2016 01:00,50,28,22,18,9,wolkig
22/06/2016 02:00,16,5,11,18,9,Regen
22/06/2016 03:00,19,7,12,18,7,wolkig
22/06/2016 04:00,12,6,6,17,9,wolkig
22/06/2016 05:00,102,47,55,17,7,teilweise bewölkt
22/06/2016 06:00,349,162,187,17,6,wolkig
22/06/2016 07:00,1035,715,320,18,7,wolkig
22/06/2016 08:00,993,697,296,18,11,wolkig
22/06/2016 09:00,787,565,222,19,13,teilweise bewölkt
22/06/2016 10:00,684,439,245,21,17,teilweise bewölkt
22/06/2016 11:00,797,469,328,21,13,teilweise bewölkt
22/06/2016 12:00,827,407,420,22,17,wolkig
22/06/2016 13:00,954,471,483,24,17,wolkig
22/06/2016 14:00,933,418,515,24,17,teilweise bewölkt
22/06/2016 15:00,909,414,495,24,13,wolkig
22/06/2016 16:00,1056,465,591,24,15,wolkig
22/06/2016 17:00,1152,575,577,24,7,wolkig
22/06/2016 18:00,1123,476,647,24,7,teilweise bewölkt
22/06/2016 19:00,910,383,527,24,6,teilweise bewölkt
22/06/2016 20:00,682,309,373,23,4,Klarer Himmel
22/06/2016 21:00,497,195,302,21,4,Klarer Himmel
22/06/2016 22:00,422,224,198,19,2,Klarer Himmel
22/06/2016 23:00,227,102,125,19,6,teilweise bewölkt
23/06/2016 00:00,183,60,123,19,4,teilweise bewölkt
23/06/2016 01:00,84,32,52,17,4,Klarer Himmel
23/06/2016 02:00,37,25,12,16,4,Klarer Himmel
23/06/2016 03:00,64,43,21,18,4,wolkig
23/06/2016 04:00,44,35,9,18,6,wolkig
23/06/2016 05:00,111,56,55,18,6,Klarer Himmel
23/06/2016 06:00,376,173,203,19,4,teilweise bewölkt
23/06/2016 07:00,1053,729,324,21,9,Klarer Himmel
23/06/2016 08:00,945,641,304,23,9,Klarer Himmel
23/06/2016 09:00,791,559,232,25,13,Klarer Himmel
23/06/2016 10:00,629,383,246,27,13,Klarer Himmel
23/06/2016 11:00,747,403,344,28,15,Klarer Himmel
23/06/2016 12:00,833,361,472,29,19,teilweise bewölkt
23/06/2016 13:00,880,377,503,31,19,teilweise bewölkt
23/06/2016 14:00,855,373,482,31,15,Klarer Himmel
23/06/2016 15:00,1019,462,557,32,17,Klarer Himmel
23/06/2016 16:00,1112,476,636,32,15,Klarer Himmel
23/06/2016 17:00,1153,593,560,33,7,Klarer Himmel
23/06/2016 18:00,1072,568,504,28,4,Gewitter
23/06/2016 19:00,639,337,302,20,15,Gewitter
23/06/2016 20:00,476,257,219,21,15,Gewitter
23/06/2016 21:00,330,166,164,21,11,wolkig
23/06/2016 22:00,347,152,195,21,6,wolkig
23/06/2016 23:00,223,64,159,21,28,Regen
24/06/2016 00:00,108,36,72,20,13,Gewitter
24/06/2016 01:00,78,42,36,20,11,teilweise bewölkt
24/06/2016 02:00,35,13,22,19,9,teilweise bewölkt
24/06/2016 03:00,25,11,14,19,6,Gewitter
24/06/2016 04:00,17,9,8,19,4,Gewitter
24/06/2016 05:00,57,29,28,19,15,Gewitter
24/06/2016 06:00,265,126,139,19,6,Gewitter
24/06/2016 07:00,640,448,192,20,6,Regen
24/06/2016 08:00,525,371,154,19,9,Regen
24/06/2016 09:00,527,369,158,22,4,teilweise bewölkt
24/06/2016 10:00,532,339,193,22,6,Klarer Himmel
24/06/2016 11:00,624,367,257,25,6,Klarer Himmel
24/06/2016 12:00,666,330,336,27,4,teilweise bewölkt
24/06/2016 13:00,784,344,440,27,6,wolkig
24/06/2016 14:00,818,381,437,25,11,wolkig
24/06/2016 15:00,721,297,424,25,20,wolkig
24/06/2016 16:00,711,309,402,24,19,wolkig
24/06/2016 17:00,719,317,402,23,15,wolkig
24/06/2016 18:00,659,296,363,23,13,wolkig
24/06/2016 19:00,629,287,342,22,9,wolkig
24/06/2016 20:00,454,214,240,22,6,wolkig
24/06/2016 21:00,287,145,142,21,6,wolkig
24/06/2016 22:00,283,128,155,20,7,wolkig
24/06/2016 23:00,252,100,152,19,2,teilweise bewölkt
25/06/2016 00:00,206,93,113,18,4,wolkig
25/06/2016 01:00,148,55,93,18,0,teilweise bewölkt
25/06/2016 02:00,106,55,51,18,7,teilweise bewölkt
25/06/2016 03:00,80,44,36,18,7,wolkig
25/06/2016 04:00,73,47,26,18,7,wolkig
25/06/2016 05:00,58,41,17,18,6,wolkig
25/06/2016 06:00,68,33,35,18,4,wolkig
25/06/2016 07:00,161,102,59,18,9,wolkig
25/06/2016 08:00,189,111,78,18,6,Regen
25/06/2016 09:00,188,123,65,17,28,Regen
25/06/2016 10:00,214,119,95,17,4,Regen
25/06/2016 11:00,281,164,117,17,9,Regen
25/06/2016 12:00,287,149,138,17,15,Regen
25/06/2016 13:00,298,145,153,16,11,Regen
25/06/2016 14:00,307,139,168,16,11,Regen
25/06/2016 15:00,241,105,136,16,15,Regen
25/06/2016 16:00,296,137,159,15,15,Regen
25/06/2016 17:00,282,129,153,15,17,Regen
25/06/2016 18:00,346,167,179,15,9,Regen
25/06/2016 19:00,291,126,165,15,6,Regen
25/06/2016 20:00,270,120,150,15,4,Regen
25/06/2016 21:00,209,99,110,15,13,wolkig
25/06/2016 22:00,156,79,77,14,11,wolkig
25/06/2016 23:00,217,85,132,15,9,wolkig
26/06/2016 00:00,180,89,91,14,7,teilweise bewölkt
26/06/2016 01:00,115,58,57,14,13,wolkig
26/06/2016 02:00,82,43,39,14,7,teilweise bewölkt
26/06/2016 03:00,81,52,29,13,9,teilweise bewölkt
26/06/2016 04:00,60,35,25,12,7,Nebel
26/06/2016 05:00,42,30,12,12,7,teilweise bewölkt
26/06/2016 06:00,40,20,20,12,11,teilweise bewölkt
26/06/2016 07:00,56,33,23,13,9,teilweise bewölkt
26/06/2016 08:00,79,35,44,15,17,wolkig
26/06/2016 09:00,174,98,76,15,17,wolkig
26/06/2016 10:00,287,162,125,16,22,wolkig
26/06/2016 11:00,278,174,104,17,24,teilweise bewölkt
26/06/2016 12:00,364,209,155,17,20,wolkig
26/06/2016 13:00,354,186,168,18,19,teilweise bewölkt
26/06/2016 14:00,439,229,210,18,15,wolkig
26/06/2016 15:00,426,223,203,20,17,wolkig
26/06/2016 16:00,467,216,251,13,7,Regen
26/06/2016 17:00,629,307,322,17,9,teilweise bewölkt
26/06/2016 18:00,248,130,118,17,9,teilweise bewölkt
26/06/2016 19:00,184,102,82,18,13,teilweise bewölkt
26/06/2016 20:00,528,279,249,17,13,teilweise bewölkt
26/06/2016 21:00,287,168,119,16,9,teilweise bewölkt
26/06/2016 22:00,230,139,91,15,9,teilweise bewölkt
26/06/2016 23:00,134,71,63,15,7,Klarer Himmel
27/06/2016 00:00,44,24,20,14,9,Klarer Himmel
27/06/2016 01:00,18,7,11,13,9,teilweise bewölkt
27/06/2016 02:00,12,7,5,13,7,teilweise bewölkt
27/06/2016 03:00,7,2,5,13,9,teilweise bewölkt
27/06/2016 04:00,15,6,9,12,9,Klarer Himmel
27/06/2016 05:00,90,48,42,12,9,
27/06/2016 06:00,356,178,178,13,13,
27/06/2016 07:00,914,619,295,14,20,teilweise bewölkt
27/06/2016 08:00,873,599,274,15,22,teilweise bewölkt
27/06/2016 09:00,754,521,233,16,22,teilweise bewölkt
27/06/2016 10:00,680,457,223,17,20,wolkig
27/06/2016 11:00,639,379,260,19,19,wolkig
27/06/2016 12:00,703,353,350,18,26,wolkig
27/06/2016 13:00,759,388,371,19,24,wolkig
27/06/2016 14:00,739,375,364,18,22,wolkig
27/06/2016 15:00,831,428,403,18,20,wolkig
27/06/2016 16:00,918,340,578,16,15,Regen
27/06/2016 17:00,1032,441,591,17,15,wolkig
27/06/2016 18:00,869,389,480,17,9,Regen
27/06/2016 19:00,556,233,323,17,9,Regen
27/06/2016 20:00,397,149,248,15,6,wolkig
27/06/2016 21:00,296,132,164,15,9,teilweise bewölkt
27/06/2016 22:00,204,86,118,14,11,teilweise bewölkt
27/06/2016 23:00,148,70,78,13,7,Klarer Himmel
28/06/2016 00:00,63,31,32,12,7,Nebel
28/06/2016 01:00,37,19,18,11,4,Nebel
28/06/2016 02:00,13,7,6,11,0,Nebel
28/06/2016 03:00,12,7,5,10,2,Nebel
28/06/2016 04:00,8,0,8,10,2,Nebel
28/06/2016 05:00,84,40,44,10,2,Nebel
28/06/2016 06:00,375,178,197,11,4,Nebel
28/06/2016 07:00,930,592,338,13,4,teilweise bewölkt
28/06/2016 08:00,940,679,261,15,6,teilweise bewölkt
28/06/2016 09:00,821,582,239,16,7,teilweise bewölkt
28/06/2016 10:00,682,455,227,17,6,teilweise bewölkt
28/06/2016 11:00,700,416,284,19,4,teilweise bewölkt
28/06/2016 12:00,789,371,418,20,9,teilweise bewölkt
28/06/2016 13:00,839,404,435,20,9,teilweise bewölkt
28/06/2016 14:00,834,380,454,21,7,wolkig
28/06/2016 15:00,941,455,486,21,11,wolkig
28/06/2016 16:00,1066,462,604,21,7,wolkig
28/06/2016 17:00,1205,587,618,21,7,wolkig
28/06/2016 18:00,1088,476,612,21,7,wolkig
28/06/2016 19:00,847,367,480,21,7,teilweise bewölkt
28/06/2016 20:00,603,247,356,20,6,Klarer Himmel
28/06/2016 21:00,432,205,227,19,4,Klarer Himmel
28/06/2016 22:00,341,170,171,18,6,Klarer Himmel
28/06/2016 23:00,186,86,100,18,7,Klarer Himmel
29/06/2016 00:00,91,49,42,17,7,Klarer Himmel
29/06/2016 01:00,37,16,21,17,7,wolkig
29/06/2016 02:00,16,5,11,15,9,Regen
29/06/2016 03:00,5,1,4,15,9,Regen
29/06/2016 04:00,13,4,9,15,13,Regen
29/06/2016 05:00,93,44,49,14,9,
29/06/2016 06:00,338,176,162,15,13,teilweise bewölkt
29/06/2016 07:00,989,659,330,15,19,teilweise bewölkt
29/06/2016 08:00,957,668,289,16,24,wolkig
29/06/2016 09:00,750,535,215,16,24,wolkig
29/06/2016 10:00,680,427,253,16,26,wolkig
29/06/2016 11:00,656,402,254,17,24,teilweise bewölkt
29/06/2016 12:00,753,367,386,17,20,wolkig
29/06/2016 13:00,833,423,410,18,19,wolkig
29/06/2016 14:00,751,353,398,19,26,teilweise bewölkt
29/06/2016 15:00,837,390,447,20,26,teilweise bewölkt
29/06/2016 16:00,969,434,535,21,22,wolkig
29/06/2016 17:00,1121,540,581,20,20,wolkig
29/06/2016 18:00,1010,448,562,20,19,wolkig
29/06/2016 19:00,850,424,426,20,11,Klarer Himmel
29/06/2016 20:00,622,267,355,19,9,Klarer Himmel
29/06/2016 21:00,414,197,217,18,6,Klarer Himmel
29/06/2016 22:00,369,189,180,17,7,Klarer Himmel
29/06/2016 23:00,203,85,118,16,6,Klarer Himmel
30/06/2016 00:00,155,74,81,15,6,Klarer Himmel
30/06/2016 01:00,65,32,33,16,9,Klarer Himmel
30/06/2016 02:00,40,12,28,16,7,Klarer Himmel
30/06/2016 03:00,27,9,18,16,9,Klarer Himmel
30/06/2016 04:00,31,8,23,17,13,Klarer Himmel
30/06/2016 05:00,97,42,55,17,11,Klarer Himmel
30/06/2016 06:00,341,169,172,16,9,wolkig
30/06/2016 07:00,877,617,260,16,11,wolkig
30/06/2016 08:00,862,614,248,16,15,wolkig
30/06/2016 09:00,728,520,208,17,19,wolkig
30/06/2016 10:00,580,361,219,17,19,wolkig
30/06/2016 11:00,651,367,284,17,17,wolkig
30/06/2016 12:00,704,339,365,18,20,Regen
30/06/2016 13:00,815,411,404,19,20,wolkig
30/06/2016 14:00,768,359,409,19,20,wolkig
30/06/2016 15:00,881,412,469,19,15,Regen
30/06/2016 16:00,1015,462,553,19,20,Regen
30/06/2016 17:00,1027,435,592,19,13,wolkig
30/06/2016 18:00,1057,490,567,20,17,wolkig
30/06/2016 19:00,778,335,443,20,13,wolkig
30/06/2016 20:00,553,243,310,20,15,wolkig
30/06/2016 21:00,336,136,200,19,15,wolkig
30/06/2016 22:00,254,105,149,18,15,wolkig
30/06/2016 23:00,191,105,86,17,13,Klarer Himmel
01/07/2016 00:00,129,61,68,17,9,wolkig
01/07/2016 01:00,36,25,11,17,13,wolkig
01/07/2016 02:00,31,16,15,16,9,wolkig
01/07/2016 03:00,22,10,12,16,11,wolkig
01/07/2016 04:00,15,3,12,16,11,Klarer Himmel
01/07/2016 05:00,86,42,44,16,11,wolkig
01/07/2016 06:00,294,142,152,17,13,wolkig
01/07/2016 07:00,879,583,296,18,15,wolkig
01/07/2016 08:00,789,558,231,19,19,wolkig
01/07/2016 09:00,674,466,208,20,17,wolkig
01/07/2016 10:00,655,382,273,17,20,Regen
01/07/2016 11:00,652,370,282,17,17,wolkig
01/07/2016 12:00,821,423,398,20,22,wolkig
01/07/2016 13:00,879,383,496,20,19,wolkig
01/07/2016 14:00,955,445,510,20,17,wolkig
01/07/2016 15:00,843,415,428,20,20,Regen
01/07/2016 16:00,840,352,488,21,19,wolkig
01/07/2016 17:00,886,399,487,21,19,wolkig
01/07/2016 18:00,803,364,439,22,22,wolkig
01/07/2016 19:00,692,309,383,21,17,wolkig
01/07/2016 20:00,574,282,292,20,13,Klarer Himmel
01/07/2016 21:00,347,165,182,19,15,wolkig
01/07/2016 22:00,321,148,173,19,13,Klarer Himmel
01/07/2016 23:00,290,121,169,19,15,wolkig
02/07/2016 00:00,242,112,130,17,20,Regen
02/07/2016 01:00,155,80,75,16,11,Regen
02/07/2016 02:00,93,46,47,16,11,Regen
02/07/2016 03:00,42,26,16,15,11,Regen
02/07/2016 04:00,38,24,14,14,32,Regen
02/07/2016 05:00,44,32,12,14,15,Regen
02/07/2016 06:00,66,35,31,14,17,wolkig
02/07/2016 07:00,147,84,63,14,20,wolkig
02/07/2016 08:00,258,152,106,14,19,wolkig
02/07/2016 09:00,496,338,158,15,22,wolkig
02/07/2016 10:00,636,398,238,15,19,wolkig
02/07/2016 11:00,658,417,241,14,20,Regen
02/07/2016 12:00,738,409,329,17,22,teilweise bewölkt
02/07/2016 13:00,744,346,398,15,22,Regen
02/07/2016 14:00,700,301,399,19,22,teilweise bewölkt
02/07/2016 15:00,648,307,341,14,6,Regen
02/07/2016 16:00,614,284,330,16,15,teilweise bewölkt
02/07/2016 17:00,447,187,260,15,26,Regen
02/07/2016 18:00,610,281,329,16,17,teilweise bewölkt
02/07/2016 19:00,568,261,307,16,19,teilweise bewölkt
02/07/2016 20:00,560,261,299,15,13,teilweise bewölkt
02/07/2016 21:00,153,93,60,14,11,teilweise bewölkt
02/07/2016 22:00,125,82,43,13,11,teilweise bewölkt
02/07/2016 23:00,138,81,57,13,9,Klarer Himmel
03/07/2016 00:00,537,277,260,12,9,Klarer Himmel
03/07/2016 01:00,236,106,130,12,9,teilweise bewölkt
03/07/2016 02:00,146,63,83,11,9,teilweise bewölkt
03/07/2016 03:00,126,81,45,11,11,Klarer Himmel
03/07/2016 04:00,82,58,24,11,11,teilweise bewölkt
03/07/2016 05:00,49,30,19,11,9,teilweise bewölkt
03/07/2016 06:00,46,26,20,11,11,teilweise bewölkt
03/07/2016 07:00,35,13,22,13,17,wolkig
03/07/2016 08:00,73,29,44,13,19,Regen
03/07/2016 09:00,155,102,53,13,15,wolkig
03/07/2016 10:00,263,154,109,15,13,wolkig
03/07/2016 11:00,269,132,137,17,15,teilweise bewölkt
03/07/2016 12:00,329,196,133,15,7,Gewitter
03/07/2016 13:00,400,219,181,19,19,teilweise bewölkt
03/07/2016 14:00,421,225,196,17,28,teilweise bewölkt
03/07/2016 15:00,387,209,178,18,19,wolkig
03/07/2016 16:00,423,237,186,19,19,teilweise bewölkt
03/07/2016 17:00,510,274,236,19,17,teilweise bewölkt
03/07/2016 18:00,447,240,207,19,15,teilweise bewölkt
03/07/2016 19:00,420,249,171,16,11,teilweise bewölkt
03/07/2016 20:00,329,161,168,16,9,wolkig
03/07/2016 21:00,193,113,80,14,6,teilweise bewölkt
03/07/2016 22:00,121,73,48,13,6,teilweise bewölkt
03/07/2016 23:00,133,70,63,12,2,Klarer Himmel
04/07/2016 00:00,56,40,16,11,2,Nebel
04/07/2016 01:00,22,12,10,10,2,Nebel
04/07/2016 02:00,9,5,4,11,2,Nebel
04/07/2016 03:00,5,1,4,11,2,Nebel
04/07/2016 04:00,8,2,6,10,2,Nebel
04/07/2016 05:00,98,48,50,11,2,Klarer Himmel
04/07/2016 06:00,327,157,170,12,2,Klarer Himmel
04/07/2016 07:00,918,607,311,13,4,Klarer Himmel
04/07/2016 08:00,897,638,259,15,6,Klarer Himmel
04/07/2016 09:00,770,574,196,18,6,wolkig
04/07/2016 10:00,687,431,256,19,7,teilweise bewölkt
04/07/2016 11:00,771,435,336,20,9,teilweise bewölkt
04/07/2016 12:00,756,394,362,20,11,teilweise bewölkt
04/07/2016 13:00,829,424,405,21,9,teilweise bewölkt
04/07/2016 14:00,814,399,415,22,9,teilweise bewölkt
04/07/2016 15:00,855,402,453,22,9,teilweise bewölkt
04/07/2016 16:00,979,439,540,22,11,teilweise bewölkt
04/07/2016 17:00,1161,576,585,22,11,teilweise bewölkt
04/07/2016 18:00,1043,461,582,22,11,teilweise bewölkt
04/07/2016 19:00,870,336,534,21,6,wolkig
04/07/2016 20:00,489,215,274,20,9,teilweise bewölkt
04/07/2016 21:00,432,216,216,18,6,Klarer Himmel
04/07/2016 22:00,322,153,169,17,2,Klarer Himmel
04/07/2016 23:00,188,94,94,15,2,Klarer Himmel
05/07/2016 00:00,78,40,38,15,4,wolkig
05/07/2016 01:00,22,13,9,14,2,Klarer Himmel
05/07/2016 02:00,16,9,7,13,2,Nebel
05/07/2016 03:00,13,4,9,13,6,Nebel
05/07/2016 04:00,16,6,10,13,2,Nebel
05/07/2016 05:00,90,42,48,14,6,wolkig
05/07/2016 06:00,358,169,189,15,6,Klarer Himmel
05/07/2016 07:00,936,620,316,17,15,Klarer Himmel
05/07/2016 08:00,1024,720,304,18,20,
05/07/2016 09:00,741,528,213,19,26,teilweise bewölkt
05/07/2016 10:00,678,422,256,19,20,wolkig
05/07/2016 11:00,587,339,248,19,26,wolkig
05/07/2016 12:00,669,307,362,18,28,wolkig
05/07/2016 13:00,746,368,378,17,26,Regen
05/07/2016 14:00,719,319,400,19,22,wolkig
05/07/2016 15:00,809,392,417,19,26,wolkig
05/07/2016 16:00,996,454,542,19,28,wolkig
05/07/2016 17:00,1100,493,607,19,35,teilweise bewölkt
05/07/2016 18:00,1041,473,568,18,41,teilweise bewölkt
05/07/2016 19:00,864,403,461,16,35,wolkig
05/07/2016 20:00,524,206,318,15,26,wolkig
05/07/2016 21:00,383,191,192,14,24,wolkig
05/07/2016 22:00,308,152,156,14,19,wolkig
05/07/2016 23:00,177,83,94,14,20,wolkig
06/07/2016 00:00,65,31,34,13,17,wolkig
06/07/2016 01:00,34,18,16,13,17,wolkig
06/07/2016 02:00,21,8,13,13,17,wolkig
06/07/2016 03:00,13,3,10,12,15,wolkig
06/07/2016 04:00,13,6,7,12,15,wolkig
06/07/2016 05:00,94,46,48,12,13,teilweise bewölkt
06/07/2016 06:00,360,179,181,12,17,teilweise bewölkt
06/07/2016 07:00,1028,693,335,13,19,teilweise bewölkt
06/07/2016 08:00,1004,706,298,15,20,teilweise bewölkt
06/07/2016 09:00,778,548,230,15,22,teilweise bewölkt
06/07/2016 10:00,695,463,232,16,20,teilweise bewölkt
06/07/2016 11:00,791,477,314,16,17,wolkig
06/07/2016 12:00,882,421,461,17,17,wolkig
06/07/2016 13:00,891,422,469,19,22,teilweise bewölkt
06/07/2016 14:00,892,395,497,19,19,teilweise bewölkt
06/07/2016 15:00,927,430,497,20,22,teilweise bewölkt
06/07/2016 16:00,1064,450,614,19,22,teilweise bewölkt
06/07/2016 17:00,1179,570,609,19,20,teilweise bewölkt
06/07/2016 18:00,1067,456,611,19,19,teilweise bewölkt
06/07/2016 19:00,830,379,451,19,17,teilweise bewölkt
06/07/2016 20:00,659,294,365,17,13,teilweise bewölkt
06/07/2016 21:00,401,186,215,15,9,wolkig
06/07/2016 22:00,292,151,141,14,9,Klarer Himmel
06/07/2016 23:00,248,131,117,13,9,Klarer Himmel
07/07/2016 00:00,108,55,53,13,6,Klarer Himmel
07/07/2016 01:00,54,23,31,11,6,Klarer Himmel
07/07/2016 02:00,38,12,26,10,2,Klarer Himmel
07/07/2016 03:00,33,12,21,9,2,Klarer Himmel
07/07/2016 04:00,18,7,11,9,4,Nebel
07/07/2016 05:00,115,58,57,8,0,Nebel
07/07/2016 06:00,309,148,161,10,6,Klarer Himmel
07/07/2016 07:00,925,613,312,13,6,Klarer Himmel
07/07/2016 08:00,1019,716,303,15,7,Klarer Himmel
07/07/2016 09:00,800,586,214,16,7,teilweise bewölkt
07/07/2016 10:00,636,390,246,17,9,teilweise bewölkt
07/07/2016 11:00,673,387,286,18,11,teilweise bewölkt
07/07/2016 12:00,837,397,440,19,11,wolkig
07/07/2016 13:00,900,451,449,20,13,Klarer Himmel
07/07/2016 14:00,865,409,456,21,9,Klarer Himmel
07/07/2016 15:00,980,451,529,22,15,Klarer Himmel
07/07/2016 16:00,1063,478,585,22,15,Klarer Himmel
07/07/2016 17:00,1160,543,617,22,17,Klarer Himmel
07/07/2016 18:00,1118,490,628,22,15,Klarer Himmel
07/07/2016 19:00,1131,559,572,22,11,Klarer Himmel
07/07/2016 20:00,910,441,469,20,6,Klarer Himmel
07/07/2016 21:00,194,100,94,17,2,Klarer Himmel
07/07/2016 22:00,162,53,109,16,4,Klarer Himmel
07/07/2016 23:00,934,431,503,15,4,Klarer Himmel
08/07/2016 00:00,199,112,87,15,4,Klarer Himmel
08/07/2016 01:00,101,53,48,15,7,Klarer Himmel
08/07/2016 02:00,45,20,25,15,4,Klarer Himmel
08/07/2016 03:00,30,4,26,15,6,Klarer Himmel
08/07/2016 04:00,25,10,15,15,2,Klarer Himmel
08/07/2016 05:00,79,49,30,15,2,Klarer Himmel
08/07/2016 06:00,283,136,147,16,6,Klarer Himmel
08/07/2016 07:00,827,553,274,17,4,Klarer Himmel
08/07/2016 08:00,826,581,245,18,6,Klarer Himmel
08/07/2016 09:00,716,509,207,19,7,Klarer Himmel
08/07/2016 10:00,734,400,334,21,11,Klarer Himmel
08/07/2016 11:00,772,432,340,22,17,Klarer Himmel
08/07/2016 12:00,808,416,392,22,24,wolkig
08/07/2016 13:00,876,387,489,20,20,wolkig
08/07/2016 14:00,847,401,446,21,33,wolkig
08/07/2016 15:00,847,403,444,20,26,Regen
08/07/2016 16:00,925,431,494,20,22,wolkig
08/07/2016 17:00,896,432,464,21,30,wolkig
08/07/2016 18:00,872,422,450,20,24,wolkig
08/07/2016 19:00,762,402,360,19,24,teilweise bewölkt
08/07/2016 20:00,546,282,264,19,17,teilweise bewölkt
08/07/2016 21:00,410,195,215,18,15,teilweise bewölkt
08/07/2016 22:00,378,156,222,16,20,Regen
08/07/2016 23:00,323,112,211,16,9,teilweise bewölkt
09/07/2016 00:00,300,73,227,15,7,wolkig
09/07/2016 01:00,178,76,102,15,9,Klarer Himmel
09/07/2016 02:00,95,42,53,15,7,wolkig
09/07/2016 03:00,82,34,48,14,6,teilweise bewölkt
09/07/2016 04:00,52,25,27,15,7,wolkig
09/07/2016 05:00,59,39,20,14,6,Nebel
09/07/2016 06:00,69,30,39,15,9,
09/07/2016 07:00,132,75,57,17,13,teilweise bewölkt
09/07/2016 08:00,253,150,103,17,13,teilweise bewölkt
09/07/2016 09:00,466,310,156,19,15,wolkig
09/07/2016 10:00,687,473,214,20,20,wolkig
09/07/2016 11:00,752,473,279,20,17,wolkig
09/07/2016 12:00,827,457,370,21,15,wolkig
09/07/2016 13:00,808,416,392,21,17,teilweise bewölkt
09/07/2016 14:00,832,387,445,23,19,teilweise bewölkt
09/07/2016 15:00,736,379,357,23,17,teilweise bewölkt
09/07/2016 16:00,800,398,402,23,20,wolkig
09/07/2016 17:00,845,406,439,22,20,Regen
09/07/2016 18:00,786,412,374,22,11,wolkig
09/07/2016 19:00,770,416,354,22,9,Klarer Himmel
09/07/2016 20:00,580,310,270,22,7,wolkig
09/07/2016 21:00,475,233,242,20,7,Klarer Himmel
09/07/2016 22:00,393,178,215,20,9,Klarer Himmel
09/07/2016 23:00,331,91,240,20,11,wolkig
10/07/2016 00:00,475,113,362,20,7,wolkig
10/07/2016 01:00,243,81,162,18,6,Klarer Himmel
10/07/2016 02:00,165,73,92,18,9,Klarer Himmel
10/07/2016 03:00,111,52,59,19,11,Klarer Himmel
10/07/2016 04:00,72,44,28,17,9,Klarer Himmel
10/07/2016 05:00,48,36,12,17,4,Klarer Himmel
10/07/2016 06:00,35,16,19,18,7,Klarer Himmel
10/07/2016 07:00,51,26,25,19,9,Klarer Himmel
10/07/2016 08:00,88,40,48,22,11,Klarer Himmel
10/07/2016 09:00,230,151,79,24,15,Klarer Himmel
10/07/2016 10:00,304,187,117,25,17,Klarer Himmel
10/07/2016 11:00,380,224,156,26,19,teilweise bewölkt
10/07/2016 12:00,432,245,187,27,20,wolkig
10/07/2016 13:00,544,292,252,28,22,teilweise bewölkt
10/07/2016 14:00,591,322,269,28,24,Klarer Himmel
10/07/2016 15:00,615,319,296,29,20,Klarer Himmel
10/07/2016 16:00,679,335,344,29,17,Klarer Himmel
10/07/2016 17:00,609,311,298,29,20,Klarer Himmel
10/07/2016 18:00,592,330,262,29,13,Klarer Himmel
10/07/2016 19:00,552,312,240,28,7,Klarer Himmel
10/07/2016 20:00,525,283,242,26,7,Klarer Himmel
10/07/2016 21:00,261,140,121,25,6,Klarer Himmel
10/07/2016 22:00,171,92,79,24,15,Klarer Himmel
10/07/2016 23:00,191,95,96,21,15,Klarer Himmel
11/07/2016 00:00,111,57,54,20,7,Klarer Himmel
11/07/2016 01:00,35,18,17,20,6,Klarer Himmel
11/07/2016 02:00,18,11,7,20,15,Klarer Himmel
11/07/2016 03:00,12,2,10,19,15,Klarer Himmel
11/07/2016 04:00,11,5,6,19,13,Klarer Himmel
11/07/2016 05:00,91,50,41,19,13,
11/07/2016 06:00,281,156,125,19,15,wolkig
11/07/2016 07:00,617,410,207,19,19,wolkig
11/07/2016 08:00,786,559,227,19,26,wolkig
11/07/2016 09:00,702,522,180,19,22,wolkig
11/07/2016 10:00,626,411,215,20,24,wolkig
11/07/2016 11:00,577,371,206,21,28,wolkig
11/07/2016 12:00,680,361,319,22,28,teilweise bewölkt
11/07/2016 13:00,724,357,367,22,30,wolkig
11/07/2016 14:00,761,394,367,22,28,wolkig
11/07/2016 15:00,770,370,400,23,32,wolkig
11/07/2016 16:00,939,392,547,23,28,teilweise bewölkt
11/07/2016 17:00,1110,517,593,23,26,teilweise bewölkt
11/07/2016 18:00,1027,414,613,23,28,Klarer Himmel
11/07/2016 19:00,737,298,439,22,24,Klarer Himmel
11/07/2016 20:00,485,194,291,22,20,Klarer Himmel
11/07/2016 21:00,332,149,183,21,17,wolkig
11/07/2016 22:00,288,147,141,19,11,teilweise bewölkt
11/07/2016 23:00,159,95,64,19,13,teilweise bewölkt
12/07/2016 00:00,69,41,28,18,11,Klarer Himmel
12/07/2016 01:00,31,18,13,17,11,Klarer Himmel
12/07/2016 02:00,22,13,9,16,11,Klarer Himmel
12/07/2016 03:00,10,1,9,16,11,Klarer Himmel
12/07/2016 04:00,17,7,10,16,9,Klarer Himmel
12/07/2016 05:00,88,39,49,15,11,Klarer Himmel
12/07/2016 06:00,310,156,154,15,15,teilweise bewölkt
12/07/2016 07:00,705,449,256,16,19,teilweise bewölkt
12/07/2016 08:00,863,625,238,17,19,teilweise bewölkt
12/07/2016 09:00,689,491,198,19,19,teilweise bewölkt
12/07/2016 10:00,653,414,239,19,20,wolkig
12/07/2016 11:00,666,408,258,19,22,wolkig
12/07/2016 12:00,680,334,346,21,17,wolkig
12/07/2016 13:00,745,372,373,22,19,wolkig
12/07/2016 14:00,669,323,346,21,15,teilweise bewölkt
12/07/2016 15:00,844,399,445,23,22,teilweise bewölkt
12/07/2016 16:00,987,417,570,21,19,teilweise bewölkt
12/07/2016 17:00,1080,477,603,20,7,wolkig
12/07/2016 18:00,1028,438,590,20,6,wolkig
12/07/2016 19:00,753,303,450,17,4,wolkig
12/07/2016 20:00,533,222,311,16,0,teilweise bewölkt
12/07/2016 21:00,376,182,194,17,7,Regen
12/07/2016 22:00,275,155,120,16,4,wolkig
12/07/2016 23:00,155,93,62,16,6,wolkig
13/07/2016 00:00,89,61,28,15,4,Klarer Himmel
13/07/2016 01:00,38,20,18,14,0,Nebel
13/07/2016 02:00,15,7,8,13,0,Nebel
13/07/2016 03:00,13,7,6,13,6,
13/07/2016 04:00,10,2,8,12,2,Nebel
13/07/2016 05:00,87,38,49,12,2,Nebel
13/07/2016 06:00,276,135,141,13,0,wolkig
13/07/2016 07:00,703,475,228,14,4,teilweise bewölkt
13/07/2016 08:00,851,613,238,15,2,wolkig
13/07/2016 09:00,743,546,197,17,6,teilweise bewölkt
13/07/2016 10:00,688,435,253,18,9,wolkig
13/07/2016 11:00,727,461,266,19,15,wolkig
13/07/2016 12:00,797,394,403,19,9,wolkig
13/07/2016 13:00,848,389,459,20,15,teilweise bewölkt
13/07/2016 14:00,744,335,409,21,13,
13/07/2016 15:00,820,358,462,21,19,wolkig
13/07/2016 16:00,982,396,586,17,19,wolkig
13/07/2016 17:00,1057,481,576,15,11,Regen
13/07/2016 18:00,881,355,526,15,6,wolkig
13/07/2016 19:00,701,322,379,15,7,wolkig
13/07/2016 20:00,491,224,267,15,9,wolkig
13/07/2016 21:00,309,135,174,15,9,wolkig
13/07/2016 22:00,296,163,133,14,11,wolkig
13/07/2016 23:00,178,91,87,13,6,wolkig
14/07/2016 00:00,91,46,45,13,6,Klarer Himmel
14/07/2016 01:00,61,23,38,12,9,wolkig
14/07/2016 02:00,39,13,26,11,7,Klarer Himmel
14/07/2016 03:00,22,11,11,10,7,Klarer Himmel
14/07/2016 04:00,30,16,14,10,4,Nebel
14/07/2016 05:00,96,50,46,10,6,Nebel
14/07/2016 06:00,290,138,152,11,4,teilweise bewölkt
14/07/2016 07:00,639,416,223,12,7,teilweise bewölkt
14/07/2016 08:00,829,586,243,14,13,teilweise bewölkt
14/07/2016 09:00,674,513,161,16,13,
14/07/2016 10:00,622,387,235,16,11,teilweise bewölkt
14/07/2016 11:00,638,351,287,16,13,teilweise bewölkt
14/07/2016 12:00,599,290,309,18,19,teilweise bewölkt
14/07/2016 13:00,671,348,323,17,15,teilweise bewölkt
14/07/2016 14:00,723,347,376,16,2,wolkig
14/07/2016 15:00,770,340,430,16,15,teilweise bewölkt
14/07/2016 16:00,937,411,526,15,15,teilweise bewölkt
14/07/2016 17:00,1029,450,579,17,19,wolkig
14/07/2016 18:00,967,414,553,16,19,wolkig
14/07/2016 19:00,770,302,468,14,20,wolkig
14/07/2016 20:00,451,176,275,13,19,wolkig
14/07/2016 21:00,340,161,179,14,15,wolkig
14/07/2016 22:00,303,157,146,13,11,teilweise bewölkt
14/07/2016 23:00,187,111,76,12,11,Klarer Himmel
15/07/2016 00:00,88,42,46,11,9,Klarer Himmel
15/07/2016 01:00,49,22,27,12,11,Klarer Himmel
15/07/2016 02:00,22,7,15,12,13,wolkig
15/07/2016 03:00,18,4,14,12,11,Klarer Himmel
15/07/2016 04:00,17,6,11,12,13,wolkig
15/07/2016 05:00,91,44,47,12,9,wolkig
15/07/2016 06:00,245,120,125,13,13,wolkig
15/07/2016 07:00,557,376,181,13,17,wolkig
15/07/2016 08:00,705,522,183,15,17,wolkig
15/07/2016 09:00,638,454,184,15,17,teilweise bewölkt
15/07/2016 10:00,529,348,181,15,19,teilweise bewölkt
15/07/2016 11:00,605,363,242,16,19,
15/07/2016 12:00,673,358,315,18,19,wolkig
15/07/2016 13:00,775,352,423,19,19,wolkig
15/07/2016 14:00,778,346,432,19,17,teilweise bewölkt
15/07/2016 15:00,796,376,420,19,15,wolkig
15/07/2016 16:00,815,364,451,19,6,wolkig
15/07/2016 17:00,872,390,482,20,20,wolkig
15/07/2016 18:00,800,329,471,19,11,wolkig
15/07/2016 19:00,717,362,355,19,7,wolkig
15/07/2016 20:00,601,336,265,18,7,teilweise bewölkt
15/07/2016 21:00,478,240,238,16,6,teilweise bewölkt
15/07/2016 22:00,400,160,240,13,0,Nebel
15/07/2016 23:00,320,99,221,12,2,Nebel
16/07/2016 00:00,249,83,166,11,4,Nebel
16/07/2016 01:00,187,60,127,11,0,Nebel
16/07/2016 02:00,115,47,68,12,6,Nebel
16/07/2016 03:00,76,45,31,13,7,Klarer Himmel
16/07/2016 04:00,53,31,22,14,7,Klarer Himmel
16/07/2016 05:00,62,43,19,15,6,Regen
16/07/2016 06:00,77,39,38,15,9,wolkig
16/07/2016 07:00,130,77,53,16,9,wolkig
16/07/2016 08:00,218,134,84,16,11,wolkig
16/07/2016 09:00,433,306,127,17,11,wolkig
16/07/2016 10:00,586,376,210,18,17,wolkig
16/07/2016 11:00,726,482,244,18,15,wolkig
16/07/2016 12:00,760,430,330,19,15,wolkig
16/07/2016 13:00,728,350,378,20,13,wolkig
16/07/2016 14:00,759,349,410,21,15,wolkig
16/07/2016 15:00,672,271,401,21,17,wolkig
16/07/2016 16:00,601,274,327,21,20,wolkig
16/07/2016 17:00,613,266,347,21,15,wolkig
16/07/2016 18:00,581,227,354,21,13,wolkig
16/07/2016 19:00,576,246,330,22,15,wolkig
16/07/2016 20:00,441,180,261,21,13,wolkig
16/07/2016 21:00,301,152,149,20,6,wolkig
16/07/2016 22:00,225,111,114,19,4,teilweise bewölkt
16/07/2016 23:00,241,112,129,19,4,wolkig
17/07/2016 00:00,225,113,112,19,7,Klarer Himmel
17/07/2016 01:00,167,77,90,19,7,wolkig
17/07/2016 02:00,136,75,61,19,7,wolkig
17/07/2016 03:00,99,58,41,19,9,wolkig
17/07/2016 04:00,61,41,20,19,9,wolkig
17/07/2016 05:00,45,32,13,19,9,wolkig
17/07/2016 06:00,41,29,12,19,11,teilweise bewölkt
17/07/2016 07:00,55,23,32,19,15,wolkig
17/07/2016 08:00,85,37,48,19,13,wolkig
17/07/2016 09:00,228,126,102,20,17,wolkig
17/07/2016 10:00,302,151,151,21,19,wolkig
17/07/2016 11:00,322,157,165,22,19,wolkig
17/07/2016 12:00,376,216,160,22,24,wolkig
17/07/2016 13:00,407,241,166,24,24,wolkig
17/07/2016 14:00,470,276,194,24,20,teilweise bewölkt
17/07/2016 15:00,510,294,216,25,28,wolkig
17/07/2016 16:00,493,274,219,24,20,wolkig
17/07/2016 17:00,492,238,254,24,22,Klarer Himmel
17/07/2016 18:00,475,236,239,23,20,wolkig
17/07/2016 19:00,468,226,242,22,15,Klarer Himmel
17/07/2016 20:00,349,181,168,21,9,Klarer Himmel
17/07/2016 21:00,261,147,114,19,7,Klarer Himmel
17/07/2016 22:00,208,125,83,17,6,Klarer Himmel
17/07/2016 23:00,128,85,43,16,6,Klarer Himmel
18/07/2016 00:00,56,32,24,15,6,Klarer Himmel
18/07/2016 01:00,35,24,11,14,7,Klarer Himmel
18/07/2016 02:00,11,10,1,16,6,Klarer Himmel
18/07/2016 03:00,5,1,4,13,2,wolkig
18/07/2016 04:00,16,10,6,12,0,Nebel
18/07/2016 05:00,88,44,44,13,4,Nebel
18/07/2016 06:00,279,149,130,15,4,wolkig
18/07/2016 07:00,628,411,217,16,6,Regen
18/07/2016 08:00,746,528,218,18,7,teilweise bewölkt
18/07/2016 09:00,618,431,187,20,7,teilweise bewölkt
18/07/2016 10:00,588,389,199,22,17,teilweise bewölkt
18/07/2016 11:00,633,371,262,23,15,teilweise bewölkt
18/07/2016 12:00,670,339,331,25,22,teilweise bewölkt
18/07/2016 13:00,660,343,317,25,17,teilweise bewölkt
18/07/2016 14:00,662,336,326,26,17,teilweise bewölkt
18/07/2016 15:00,833,368,465,27,19,Klarer Himmel
18/07/2016 16:00,926,411,515,27,15,Klarer Himmel
18/07/2016 17:00,1109,513,596,26,15,Klarer Himmel
18/07/2016 18:00,920,403,517,26,17,Klarer Himmel
18/07/2016 19:00,710,298,412,25,9,Klarer Himmel
18/07/2016 20:00,591,284,307,24,7,Klarer Himmel
18/07/2016 21:00,371,174,197,20,2,Klarer Himmel
18/07/2016 22:00,348,176,172,17,0,Klarer Himmel
18/07/2016 23:00,174,87,87,16,0,Klarer Himmel
19/07/2016 00:00,84,34,50,15,0,Klarer Himmel
19/07/2016 01:00,48,27,21,14,0,Klarer Himmel
19/07/2016 02:00,33,12,21,13,2,Klarer Himmel
19/07/2016 03:00,7,4,3,13,2,Klarer Himmel
19/07/2016 04:00,17,7,10,12,0,Nebel
19/07/2016 05:00,80,42,38,12,4,Nebel
19/07/2016 06:00,309,165,144,13,0,Klarer Himmel
19/07/2016 07:00,681,455,226,18,2,Klarer Himmel
19/07/2016 08:00,835,582,253,20,6,Klarer Himmel
19/07/2016 09:00,649,461,188,23,4,Klarer Himmel
19/07/2016 10:00,613,400,213,24,6,Klarer Himmel
19/07/2016 11:00,657,392,265,25,6,Klarer Himmel
19/07/2016 12:00,670,292,378,27,4,Klarer Himmel
19/07/2016 13:00,704,312,392,28,4,Klarer Himmel
19/07/2016 14:00,660,290,370,28,6,Klarer Himmel
19/07/2016 15:00,857,380,477,29,6,Klarer Himmel
19/07/2016 16:00,980,399,581,30,6,Klarer Himmel
19/07/2016 17:00,1096,509,587,29,4,Klarer Himmel
19/07/2016 18:00,1057,493,564,30,2,Klarer Himmel
19/07/2016 19:00,863,418,445,29,7,Klarer Himmel
19/07/2016 20:00,680,370,310,26,7,Klarer Himmel
19/07/2016 21:00,516,267,249,24,6,Klarer Himmel
19/07/2016 22:00,415,240,175,23,6,Klarer Himmel
19/07/2016 23:00,240,126,114,21,6,Klarer Himmel
20/07/2016 00:00,128,58,70,20,6,Klarer Himmel
20/07/2016 01:00,55,27,28,21,7,Klarer Himmel
20/07/2016 02:00,31,19,12,20,6,Klarer Himmel
20/07/2016 03:00,21,6,15,20,7,Klarer Himmel
20/07/2016 04:00,13,5,8,20,7,Klarer Himmel
20/07/2016 05:00,91,55,36,20,9,Klarer Himmel
20/07/2016 06:00,312,161,151,21,9,Klarer Himmel
20/07/2016 07:00,663,418,245,22,9,Klarer Himmel
20/07/2016 08:00,820,586,234,24,7,Klarer Himmel
20/07/2016 09:00,709,508,201,25,11,Klarer Himmel
20/07/2016 10:00,660,393,267,28,13,Klarer Himmel
20/07/2016 11:00,697,400,297,29,13,Klarer Himmel
20/07/2016 12:00,736,329,407,31,13,Klarer Himmel
20/07/2016 13:00,756,319,437,32,19,Klarer Himmel
20/07/2016 14:00,732,293,439,33,17,Klarer Himmel
20/07/2016 15:00,835,322,513,34,15,Klarer Himmel
20/07/2016 16:00,960,372,588,34,17,Klarer Himmel
20/07/2016 17:00,988,452,536,33,11,Klarer Himmel
20/07/2016 18:00,1020,536,484,31,6,Klarer Himmel
20/07/2016 19:00,896,517,379,30,4,wolkig
20/07/2016 20:00,439,263,176,23,22,Gewitter
20/07/2016 21:00,362,199,163,21,7,wolkig
20/07/2016 22:00,316,167,149,21,6,Klarer Himmel
20/07/2016 23:00,188,105,83,20,4,Klarer Himmel
21/07/2016 00:00,124,47,77,20,4,wolkig
21/07/2016 01:00,73,46,27,20,2,Klarer Himmel
21/07/2016 02:00,38,21,17,19,0,Nebel
21/07/2016 03:00,37,15,22,18,0,Nebel
21/07/2016 04:00,29,13,16,18,0,Nebel
21/07/2016 05:00,89,49,40,17,4,Nebel
21/07/2016 06:00,278,132,146,18,4,Nebel
21/07/2016 07:00,565,358,207,20,6,
21/07/2016 08:00,730,517,213,22,9,
21/07/2016 09:00,655,470,185,23,7,Klarer Himmel
21/07/2016 10:00,488,390,98,25,7,Klarer Himmel
21/07/2016 11:00,626,376,250,25,11,teilweise bewölkt
21/07/2016 12:00,650,297,353,26,9,teilweise bewölkt
21/07/2016 13:00,672,326,346,27,7,teilweise bewölkt
21/07/2016 14:00,677,327,350,29,7,teilweise bewölkt
21/07/2016 15:00,758,347,411,29,6,teilweise bewölkt
21/07/2016 16:00,904,379,525,30,4,teilweise bewölkt
21/07/2016 17:00,963,442,521,28,2,wolkig
21/07/2016 18:00,901,357,544,18,24,Gewitter
21/07/2016 19:00,524,242,282,21,4,Regen
21/07/2016 20:00,461,189,272,21,4,Nebel
21/07/2016 21:00,377,169,208,20,0,Nebel
21/07/2016 22:00,304,139,165,19,2,Nebel
21/07/2016 23:00,180,93,87,19,6,teilweise bewölkt
22/07/2016 00:00,103,59,44,18,2,Klarer Himmel
22/07/2016 01:00,62,42,20,18,2,
22/07/2016 02:00,32,26,6,18,2,
22/07/2016 03:00,28,15,13,19,2,
22/07/2016 04:00,20,10,10,18,0,Nebel
22/07/2016 05:00,78,42,36,18,0,Nebel
22/07/2016 06:00,236,119,117,19,0,Nebel
22/07/2016 07:00,510,347,163,20,6,Nebel
22/07/2016 08:00,614,443,171,20,7,wolkig
22/07/2016 09:00,583,385,198,21,13,Regen
22/07/2016 10:00,560,362,198,21,19,Regen
22/07/2016 11:00,575,343,232,22,13,wolkig
22/07/2016 12:00,588,269,319,18,15,Gewitter
22/07/2016 13:00,652,304,348,21,19,wolkig
22/07/2016 14:00,726,350,376,23,13,Klarer Himmel
22/07/2016 15:00,787,386,401,24,7,wolkig
22/07/2016 16:00,750,319,431,24,6,wolkig
22/07/2016 17:00,772,333,439,25,7,Klarer Himmel
22/07/2016 18:00,768,321,447,25,7,Klarer Himmel
22/07/2016 19:00,721,288,433,25,7,Klarer Himmel
22/07/2016 20:00,529,247,282,23,9,Klarer Himmel
22/07/2016 21:00,347,183,164,21,11,Klarer Himmel
22/07/2016 22:00,314,162,152,20,4,Klarer Himmel
22/07/2016 23:00,282,154,128,20,13,Klarer Himmel
23/07/2016 00:00,236,123,113,19,7,Klarer Himmel
23/07/2016 01:00,160,91,69,19,7,Klarer Himmel
23/07/2016 02:00,132,73,59,19,6,Klarer Himmel
23/07/2016 03:00,91,51,40,18,4,
23/07/2016 04:00,50,31,19,18,6,
23/07/2016 05:00,76,44,32,18,7,Nebel
23/07/2016 06:00,69,42,27,18,2,Nebel
23/07/2016 07:00,145,92,53,19,7,Nebel
23/07/2016 08:00,252,148,104,19,11,wolkig
23/07/2016 09:00,405,274,131,20,15,wolkig
23/07/2016 10:00,556,379,177,21,11,wolkig
23/07/2016 11:00,672,419,253,21,13,wolkig
23/07/2016 12:00,672,347,325,22,9,wolkig
23/07/2016 13:00,734,383,351,22,9,wolkig
23/07/2016 14:00,636,299,337,24,6,wolkig
23/07/2016 15:00,578,243,335,24,7,wolkig
23/07/2016 16:00,566,234,332,24,4,wolkig
23/07/2016 17:00,543,240,303,25,4,teilweise bewölkt
23/07/2016 18:00,550,219,331,25,4,wolkig
23/07/2016 19:00,560,246,314,24,6,wolkig
23/07/2016 20:00,431,211,220,22,4,Klarer Himmel
23/07/2016 21:00,350,167,183,20,0,Klarer Himmel
23/07/2016 22:00,324,179,145,19,2,Klarer Himmel
23/07/2016 23:00,240,121,119,18,0,Klarer Himmel
24/07/2016 00:00,246,123,123,17,0,Klarer Himmel
24/07/2016 01:00,219,114,105,16,0,Nebel
24/07/2016 02:00,111,59,52,16,0,Nebel
24/07/2016 03:00,103,62,41,15,0,Nebel
24/07/2016 04:00,62,45,17,15,0,Nebel
24/07/2016 05:00,59,43,16,15,0,Nebel
24/07/2016 06:00,41,18,23,16,0,Nebel
24/07/2016 07:00,62,31,31,18,0,
24/07/2016 08:00,107,45,62,19,6,Klarer Himmel
24/07/2016 09:00,190,109,81,22,4,Klarer Himmel
24/07/2016 10:00,294,180,114,23,7,teilweise bewölkt
24/07/2016 11:00,324,172,152,25,7,teilweise bewölkt
24/07/2016 12:00,394,173,221,26,7,teilweise bewölkt
24/07/2016 13:00,435,198,237,26,7,teilweise bewölkt
24/07/2016 14:00,470,205,265,27,6,teilweise bewölkt
24/07/2016 15:00,511,251,260,27,7,teilweise bewölkt
24/07/2016 16:00,535,278,257,27,11,teilweise bewölkt
24/07/2016 17:00,565,309,256,26,7,wolkig
24/07/2016 18:00,525,277,248,27,7,wolkig
24/07/2016 19:00,486,302,184,26,6,Klarer Himmel
24/07/2016 20:00,401,253,148,25,4,Klarer Himmel
24/07/2016 21:00,315,187,128,22,0,Klarer Himmel
24/07/2016 22:00,219,141,78,21,0,Klarer Himmel
24/07/2016 23:00,130,72,58,22,4,Klarer Himmel
25/07/2016 00:00,81,48,33,22,6,Klarer Himmel
25/07/2016 01:00,32,17,15,21,2,Klarer Himmel
25/07/2016 02:00,21,11,10,20,0,Klarer Himmel
25/07/2016 03:00,5,4,1,20,4,Klarer Himmel
25/07/2016 04:00,22,6,16,20,0,wolkig
25/07/2016 05:00,89,38,51,19,4,wolkig
25/07/2016 06:00,283,151,132,20,9,wolkig
25/07/2016 07:00,572,366,206,20,6,wolkig
25/07/2016 08:00,635,452,183,21,4,wolkig
25/07/2016 09:00,563,401,162,23,11,wolkig
25/07/2016 10:00,552,349,203,24,15,wolkig
25/07/2016 11:00,543,324,219,25,19,wolkig
25/07/2016 12:00,661,339,322,25,17,wolkig
25/07/2016 13:00,614,306,308,26,19,teilweise bewölkt
25/07/2016 14:00,637,333,304,25,13,wolkig
25/07/2016 15:00,729,334,395,24,17,wolkig
25/07/2016 16:00,870,406,464,24,17,wolkig
25/07/2016 17:00,947,413,534,25,17,wolkig
25/07/2016 18:00,892,386,506,25,17,teilweise bewölkt
25/07/2016 19:00,679,315,364,23,13,teilweise bewölkt
25/07/2016 20:00,473,231,242,22,7,teilweise bewölkt
25/07/2016 21:00,324,143,181,21,13,teilweise bewölkt
25/07/2016 22:00,262,131,131,19,13,wolkig
25/07/2016 23:00,154,90,64,18,6,Klarer Himmel
26/07/2016 00:00,113,56,57,17,0,Klarer Himmel
26/07/2016 01:00,44,21,23,18,4,wolkig
26/07/2016 02:00,34,18,16,18,7,wolkig
26/07/2016 03:00,12,4,8,16,4,teilweise bewölkt
26/07/2016 04:00,10,4,6,16,4,teilweise bewölkt
26/07/2016 05:00,90,42,48,15,0,Nebel
26/07/2016 06:00,252,137,115,15,2,Nebel
26/07/2016 07:00,637,394,243,16,0,Klarer Himmel
26/07/2016 08:00,718,474,244,18,4,wolkig
26/07/2016 09:00,572,407,165,19,4,wolkig
26/07/2016 10:00,554,363,191,20,6,wolkig
26/07/2016 11:00,637,349,288,22,6,wolkig
26/07/2016 12:00,658,341,317,23,7,wolkig
26/07/2016 13:00,719,350,369,23,9,wolkig
26/07/2016 14:00,651,352,299,24,9,wolkig
26/07/2016 15:00,774,363,411,24,7,Klarer Himmel
26/07/2016 16:00,959,420,539,24,4,Klarer Himmel
26/07/2016 17:00,1042,478,564,24,6,Klarer Himmel
26/07/2016 18:00,968,422,546,24,4,Klarer Himmel
26/07/2016 19:00,711,316,395,23,7,Klarer Himmel
26/07/2016 20:00,495,218,277,22,4,Klarer Himmel
26/07/2016 21:00,353,183,170,20,2,Klarer Himmel
26/07/2016 22:00,326,189,137,20,4,Klarer Himmel
26/07/2016 23:00,162,75,87,19,9,Klarer Himmel
27/07/2016 00:00,138,52,86,18,4,Klarer Himmel
27/07/2016 01:00,52,22,30,18,4,Klarer Himmel
27/07/2016 02:00,20,10,10,18,6,Klarer Himmel
27/07/2016 03:00,46,35,11,17,0,Klarer Himmel
27/07/2016 04:00,29,15,14,17,6,Klarer Himmel
27/07/2016 05:00,79,48,31,17,6,Klarer Himmel
27/07/2016 06:00,291,141,150,17,7,Klarer Himmel
27/07/2016 07:00,656,412,244,17,6,Klarer Himmel
27/07/2016 08:00,748,510,238,19,7,Klarer Himmel
27/07/2016 09:00,644,444,200,20,11,wolkig
27/07/2016 10:00,687,440,247,22,13,wolkig
27/07/2016 11:00,696,403,293,22,19,wolkig
27/07/2016 12:00,757,390,367,22,22,teilweise bewölkt
27/07/2016 13:00,748,353,395,22,22,wolkig
27/07/2016 14:00,712,324,388,23,24,wolkig
27/07/2016 15:00,720,347,373,23,24,wolkig
27/07/2016 16:00,939,408,531,23,24,wolkig
27/07/2016 17:00,1009,480,529,23,26,wolkig
27/07/2016 18:00,911,382,529,22,22,wolkig
27/07/2016 19:00,670,315,355,21,13,Klarer Himmel
27/07/2016 20:00,480,243,237,21,11,wolkig
27/07/2016 21:00,345,164,181,20,17,Regen
27/07/2016 22:00,254,135,119,18,15,Regen
27/07/2016 23:00,163,87,76,17,9,wolkig
28/07/2016 00:00,148,46,102,18,11,wolkig
28/07/2016 01:00,63,24,39,18,11,wolkig
28/07/2016 02:00,36,15,21,18,15,wolkig
28/07/2016 03:00,35,20,15,16,7,Klarer Himmel
28/07/2016 04:00,45,22,23,17,4,Klarer Himmel
28/07/2016 05:00,93,51,42,15,0,Nebel
28/07/2016 06:00,287,134,153,16,2,wolkig
28/07/2016 07:00,504,327,177,17,4,wolkig
28/07/2016 08:00,518,354,164,18,4,wolkig
28/07/2016 09:00,442,306,136,17,7,Regen
28/07/2016 10:00,406,255,151,17,6,wolkig
28/07/2016 11:00,429,261,168,18,4,Regen
28/07/2016 12:00,498,264,234,19,6,Regen
28/07/2016 13:00,555,265,290,20,11,Regen
28/07/2016 14:00,492,243,249,19,17,Regen
28/07/2016 15:00,623,296,327,20,17,wolkig
28/07/2016 16:00,755,327,428,21,13,teilweise bewölkt
28/07/2016 17:00,883,420,463,22,11,wolkig
28/07/2016 18:00,811,359,452,22,6,wolkig
28/07/2016 19:00,657,283,374,22,6,wolkig
28/07/2016 20:00,410,175,235,20,11,wolkig
28/07/2016 21:00,297,140,157,19,0,wolkig
28/07/2016 22:00,234,130,104,19,11,wolkig
28/07/2016 23:00,170,95,75,18,0,wolkig
29/07/2016 00:00,107,54,53,19,4,wolkig
29/07/2016 01:00,49,18,31,18,4,wolkig
29/07/2016 02:00,34,8,26,18,7,Klarer Himmel
29/07/2016 03:00,14,6,8,17,13,wolkig
29/07/2016 04:00,25,10,15,17,6,wolkig
29/07/2016 05:00,66,40,26,17,7,wolkig
29/07/2016 06:00,216,115,101,17,7,Regen
29/07/2016 07:00,459,277,182,17,13,wolkig
29/07/2016 08:00,524,359,165,17,13,wolkig
29/07/2016 09:00,496,348,148,17,9,wolkig
29/07/2016 10:00,518,306,212,19,15,wolkig
29/07/2016 11:00,562,341,221,20,17,wolkig
29/07/2016 12:00,665,357,308,21,17,wolkig
29/07/2016 13:00,562,252,310,17,11,Regen
29/07/2016 14:00,599,279,320,21,9,wolkig
29/07/2016 15:00,675,325,350,22,13,teilweise bewölkt
29/07/2016 16:00,674,306,368,23,26,wolkig
29/07/2016 17:00,750,325,425,23,24,teilweise bewölkt
29/07/2016 18:00,711,332,379,23,22,teilweise bewölkt
29/07/2016 19:00,571,236,335,22,24,teilweise bewölkt
29/07/2016 20:00,437,211,226,21,13,wolkig
29/07/2016 21:00,330,152,178,19,17,wolkig
29/07/2016 22:00,255,114,141,19,13,Klarer Himmel
29/07/2016 23:00,204,115,89,18,9,Klarer Himmel
30/07/2016 00:00,212,103,109,18,9,Klarer Himmel
30/07/2016 01:00,139,74,65,17,9,wolkig
30/07/2016 02:00,117,61,56,17,7,Klarer Himmel
30/07/2016 03:00,102,72,30,16,9,Klarer Himmel
30/07/2016 04:00,59,36,23,16,11,wolkig
30/07/2016 05:00,83,54,29,15,7,teilweise bewölkt
30/07/2016 06:00,76,41,35,16,11,Klarer Himmel
30/07/2016 07:00,114,64,50,16,13,Klarer Himmel
30/07/2016 08:00,209,127,82,17,17,teilweise bewölkt
30/07/2016 09:00,449,296,153,18,22,teilweise bewölkt
30/07/2016 10:00,607,408,199,19,19,teilweise bewölkt
30/07/2016 11:00,734,437,297,18,24,wolkig
30/07/2016 12:00,589,323,266,18,19,wolkig
30/07/2016 13:00,679,351,328,21,20,wolkig
30/07/2016 14:00,657,290,367,20,17,wolkig
30/07/2016 15:00,600,289,311,21,15,wolkig
30/07/2016 16:00,561,242,319,20,9,Regen
30/07/2016 17:00,510,198,312,18,11,Regen
30/07/2016 18:00,485,190,295,18,9,Regen
30/07/2016 19:00,412,179,233,17,4,wolkig
30/07/2016 20:00,352,153,199,17,0,wolkig
30/07/2016 21:00,237,121,116,17,4,wolkig
30/07/2016 22:00,189,101,88,17,6,wolkig
30/07/2016 23:00,202,109,93,17,7,wolkig
31/07/2016 00:00,192,112,80,16,0,wolkig
31/07/2016 01:00,163,73,90,16,4,Nebel
31/07/2016 02:00,137,77,60,15,2,Nebel
31/07/2016 03:00,80,55,25,15,0,Nebel
31/07/2016 04:00,79,59,20,15,2,wolkig
31/07/2016 05:00,72,54,18,15,6,Nebel
31/07/2016 06:00,28,19,9,16,4,Nebel
31/07/2016 07:00,47,26,21,16,9,Nebel
31/07/2016 08:00,64,33,31,17,11,wolkig
31/07/2016 09:00,134,83,51,17,11,wolkig
31/07/2016 10:00,209,115,94,18,17,wolkig
31/07/2016 11:00,244,144,100,19,15,wolkig
31/07/2016 12:00,274,147,127,19,11,Regen
31/07/2016 13:00,293,138,155,19,17,wolkig
31/07/2016 14:00,303,189,114,20,11,wolkig
31/07/2016 15:00,319,154,165,20,9,Regen
31/07/2016 16:00,433,237,196,20,13,wolkig
31/07/2016 17:00,386,193,193,18,19,wolkig
31/07/2016 18:00,371,168,203,19,15,wolkig
31/07/2016 19:00,397,221,176,19,19,teilweise bewölkt
31/07/2016 20:00,277,151,126,17,7,teilweise bewölkt
31/07/2016 21:00,219,116,103,16,13,teilweise bewölkt
31/07/2016 22:00,121,82,39,15,9,Klarer Himmel
31/07/2016 23:00,91,57,34,14,7,Klarer Himmel
01/08/2016 00:00,43,25,18,13,7,Klarer Himmel
01/08/2016 01:00,23,14,9,12,7,Klarer Himmel
01/08/2016 02:00,15,8,7,12,6,Klarer Himmel
01/08/2016 03:00,3,1,2,13,9,Klarer Himmel
01/08/2016 04:00,13,7,6,11,7,Klarer Himmel
01/08/2016 05:00,71,41,30,12,6,Nebel
01/08/2016 06:00,258,126,132,12,6,Klarer Himmel
01/08/2016 07:00,524,329,195,13,7,Klarer Himmel
01/08/2016 08:00,617,427,190,14,7,Klarer Himmel
01/08/2016 09:00,495,348,147,17,9,Regen
01/08/2016 10:00,412,249,163,14,9,Regen
01/08/2016 11:00,499,265,234,15,4,Regen
01/08/2016 12:00,457,254,203,17,9,wolkig
01/08/2016 13:00,553,274,279,19,15,teilweise bewölkt
01/08/2016 14:00,595,298,297,19,11,teilweise bewölkt
01/08/2016 15:00,506,221,285,15,17,Regen
01/08/2016 16:00,627,282,345,17,9,teilweise bewölkt
01/08/2016 17:00,890,432,458,19,11,teilweise bewölkt
01/08/2016 18:00,818,365,453,19,9,teilweise bewölkt
01/08/2016 19:00,623,251,372,19,9,teilweise bewölkt
01/08/2016 20:00,390,192,198,17,4,Nebel
01/08/2016 21:00,255,127,128,15,2,Nebel
01/08/2016 22:00,191,101,90,13,2,Nebel
01/08/2016 23:00,115,65,50,14,4,Nebel
02/08/2016 00:00,84,43,41,14,2,Nebel
02/08/2016 01:00,32,14,18,14,0,Regen
02/08/2016 02:00,16,9,7,14,7,Regen
02/08/2016 03:00,7,6,1,15,7,Regen
02/08/2016 04:00,9,3,6,15,9,Regen
02/08/2016 05:00,59,30,29,14,6,Regen
02/08/2016 06:00,196,103,93,14,7,Regen
02/08/2016 07:00,384,231,153,14,4,Regen
02/08/2016 08:00,481,338,143,14,6,Regen
02/08/2016 09:00,419,268,151,15,7,wolkig
02/08/2016 10:00,384,248,136,15,6,Regen
02/08/2016 11:00,408,241,167,16,9,wolkig
02/08/2016 12:00,470,249,221,17,11,wolkig
02/08/2016 13:00,482,253,229,18,9,wolkig
02/08/2016 14:00,501,257,244,17,9,wolkig
02/08/2016 15:00,589,275,314,18,11,Regen
02/08/2016 16:00,727,322,405,17,15,wolkig
02/08/2016 17:00,777,350,427,18,9,wolkig
02/08/2016 18:00,687,292,395,18,13,wolkig
02/08/2016 19:00,493,219,274,17,9,Regen
02/08/2016 20:00,298,142,156,17,7,Regen
02/08/2016 21:00,200,107,93,17,9,Regen
02/08/2016 22:00,181,93,88,17,11,Regen
02/08/2016 23:00,105,47,58,18,11,wolkig
03/08/2016 00:00,50,29,21,18,13,Regen
03/08/2016 01:00,29,13,16,18,13,wolkig
03/08/2016 02:00,18,11,7,18,11,Regen
03/08/2016 03:00,9,3,6,18,13,Regen
03/08/2016 04:00,13,6,7,18,13,wolkig
03/08/2016 05:00,60,37,23,18,15,wolkig
03/08/2016 06:00,202,105,97,18,15,Regen
03/08/2016 07:00,369,227,142,18,15,Regen
03/08/2016 08:00,536,372,164,18,19,Regen
03/08/2016 09:00,430,299,131,19,19,Regen
03/08/2016 10:00,390,250,140,19,19,Regen
03/08/2016 11:00,450,285,165,19,17,Regen
03/08/2016 12:00,496,275,221,19,22,Regen
03/08/2016 13:00,450,213,237,19,20,Regen
03/08/2016 14:00,454,206,248,19,22,Regen
03/08/2016 15:00,471,210,261,19,19,Regen
03/08/2016 16:00,591,248,343,19,20,wolkig
03/08/2016 17:00,606,293,313,19,19,wolkig
03/08/2016 18:00,569,225,344,19,13,Regen
03/08/2016 19:00,455,206,249,19,15,Regen
03/08/2016 20:00,321,157,164,19,15,Regen
03/08/2016 21:00,206,104,102,19,15,Regen
03/08/2016 22:00,182,101,81,19,17,Regen
03/08/2016 23:00,116,63,53,15,19,Regen
04/08/2016 00:00,91,40,51,16,6,Klarer Himmel
04/08/2016 01:00,64,18,46,17,15,teilweise bewölkt
04/08/2016 02:00,43,22,21,17,17,teilweise bewölkt
04/08/2016 03:00,28,13,15,17,19,teilweise bewölkt
04/08/2016 04:00,37,19,18,16,11,teilweise bewölkt
04/08/2016 05:00,78,44,34,16,17,wolkig
04/08/2016 06:00,248,120,128,16,19,wolkig
04/08/2016 07:00,509,326,183,16,19,wolkig
04/08/2016 08:00,598,387,211,16,20,wolkig
04/08/2016 09:00,507,343,164,17,19,wolkig
04/08/2016 10:00,446,268,178,18,20,wolkig
04/08/2016 11:00,491,311,180,19,24,wolkig
04/08/2016 12:00,567,303,264,19,22,wolkig
04/08/2016 13:00,615,306,309,20,19,wolkig
04/08/2016 14:00,622,308,314,19,19,wolkig
04/08/2016 15:00,729,355,374,19,22,wolkig
04/08/2016 16:00,799,384,415,19,19,wolkig
04/08/2016 17:00,873,388,485,20,19,wolkig
04/08/2016 18:00,824,366,458,20,17,wolkig
04/08/2016 19:00,681,281,400,19,13,wolkig
04/08/2016 20:00,405,187,218,18,7,wolkig
04/08/2016 21:00,290,142,148,18,15,Regen
04/08/2016 22:00,231,138,93,17,11,wolkig
04/08/2016 23:00,146,82,64,16,7,Klarer Himmel
05/08/2016 00:00,106,62,44,15,6,Klarer Himmel
05/08/2016 01:00,56,27,29,14,4,Klarer Himmel
05/08/2016 02:00,20,8,12,14,6,Klarer Himmel
05/08/2016 03:00,22,7,15,14,6,Klarer Himmel
05/08/2016 04:00,13,6,7,14,7,Klarer Himmel
05/08/2016 05:00,78,41,37,13,7,Nebel
05/08/2016 06:00,230,114,116,14,9,wolkig
05/08/2016 07:00,478,325,153,15,11,wolkig
05/08/2016 08:00,561,387,174,15,13,wolkig
05/08/2016 09:00,469,312,157,16,11,wolkig
05/08/2016 10:00,463,291,172,17,13,wolkig
05/08/2016 11:00,556,312,244,19,15,wolkig
05/08/2016 12:00,628,350,278,20,22,teilweise bewölkt
05/08/2016 13:00,652,310,342,22,20,teilweise bewölkt
05/08/2016 14:00,729,349,380,20,32,Regen
05/08/2016 15:00,693,305,388,19,13,Regen
05/08/2016 16:00,718,306,412,21,13,teilweise bewölkt
05/08/2016 17:00,726,329,397,22,22,teilweise bewölkt
05/08/2016 18:00,677,258,419,21,13,teilweise bewölkt
05/08/2016 19:00,560,257,303,20,15,wolkig
05/08/2016 20:00,388,187,201,19,11,wolkig
05/08/2016 21:00,296,139,157,17,11,Klarer Himmel
05/08/2016 22:00,207,102,105,16,11,Klarer Himmel
05/08/2016 23:00,248,132,116,15,7,Klarer Himmel
06/08/2016 00:00,208,96,112,15,6,Klarer Himmel
06/08/2016 01:00,138,59,79,14,4,Klarer Himmel
06/08/2016 02:00,108,60,48,13,7,teilweise bewölkt
06/08/2016 03:00,98,66,32,14,6,teilweise bewölkt
06/08/2016 04:00,63,39,24,13,7,teilweise bewölkt
06/08/2016 05:00,63,49,14,14,7,Klarer Himmel
06/08/2016 06:00,70,40,30,14,6,Klarer Himmel
06/08/2016 07:00,117,81,36,15,7,wolkig
06/08/2016 08:00,216,119,97,16,9,Klarer Himmel
06/08/2016 09:00,374,254,120,18,15,wolkig
06/08/2016 10:00,612,419,193,18,19,wolkig
06/08/2016 11:00,660,418,242,18,17,Regen
06/08/2016 12:00,681,401,280,18,13,wolkig
06/08/2016 13:00,655,316,339,18,15,Regen
06/08/2016 14:00,389,128,261,19,11,teilweise bewölkt
06/08/2016 15:00,533,229,304,20,20,teilweise bewölkt
06/08/2016 16:00,450,203,247,20,20,teilweise bewölkt
06/08/2016 17:00,494,206,288,20,15,wolkig
06/08/2016 18:00,488,194,294,21,15,teilweise bewölkt
06/08/2016 19:00,435,209,226,21,11,teilweise bewölkt
06/08/2016 20:00,324,159,165,19,11,teilweise bewölkt
06/08/2016 21:00,266,135,131,17,11,teilweise bewölkt
06/08/2016 22:00,197,103,94,14,6,Klarer Himmel
06/08/2016 23:00,207,121,86,14,4,Klarer Himmel
07/08/2016 00:00,200,86,114,12,2,Klarer Himmel
07/08/2016 01:00,177,95,82,12,4,Nebel
07/08/2016 02:00,112,65,47,11,4,Nebel
07/08/2016 03:00,104,61,43,11,2,Nebel
07/08/2016 04:00,74,50,24,11,4,Nebel
07/08/2016 05:00,55,41,14,10,2,Nebel
07/08/2016 06:00,34,17,17,11,7,Klarer Himmel
07/08/2016 07:00,45,18,27,13,7,Klarer Himmel
07/08/2016 08:00,86,42,44,16,13,Klarer Himmel
07/08/2016 09:00,157,92,65,17,13,Klarer Himmel
07/08/2016 10:00,261,144,117,19,15,Klarer Himmel
07/08/2016 11:00,335,187,148,22,20,Klarer Himmel
07/08/2016 12:00,405,213,192,23,20,Klarer Himmel
07/08/2016 13:00,397,208,189,24,22,Klarer Himmel
07/08/2016 14:00,512,265,247,25,24,wolkig
07/08/2016 15:00,557,298,259,24,22,wolkig
07/08/2016 16:00,515,258,257,23,20,wolkig
07/08/2016 17:00,505,263,242,23,22,
07/08/2016 18:00,445,231,214,23,20,wolkig
07/08/2016 19:00,384,200,184,22,13,wolkig
07/08/2016 20:00,298,175,123,22,11,wolkig
07/08/2016 21:00,223,141,82,21,7,wolkig
07/08/2016 22:00,172,124,48,21,13,wolkig
07/08/2016 23:00,102,57,45,22,17,wolkig
08/08/2016 00:00,57,35,22,22,19,wolkig
08/08/2016 01:00,32,14,18,21,19,wolkig
08/08/2016 02:00,19,6,13,20,13,wolkig
08/08/2016 03:00,8,5,3,20,26,wolkig
08/08/2016 04:00,20,8,12,19,24,wolkig
08/08/2016 05:00,72,39,33,18,17,teilweise bewölkt
08/08/2016 06:00,279,154,125,18,19,teilweise bewölkt
08/08/2016 07:00,528,317,211,18,24,teilweise bewölkt
08/08/2016 08:00,640,435,205,18,22,wolkig
08/08/2016 09:00,469,327,142,18,19,wolkig
08/08/2016 10:00,446,288,158,17,24,wolkig
08/08/2016 11:00,554,315,239,18,19,wolkig
08/08/2016 12:00,521,265,256,18,24,wolkig
08/08/2016 13:00,451,198,253,17,20,wolkig
08/08/2016 14:00,458,226,232,20,20,teilweise bewölkt
08/08/2016 15:00,637,320,317,21,24,teilweise bewölkt
08/08/2016 16:00,813,381,432,21,28,teilweise bewölkt
08/08/2016 17:00,939,444,495,21,28,teilweise bewölkt
08/08/2016 18:00,804,349,455,19,26,Klarer Himmel
08/08/2016 19:00,651,246,405,18,15,Klarer Himmel
08/08/2016 20:00,427,182,245,16,9,Klarer Himmel
08/08/2016 21:00,278,148,130,14,6,Klarer Himmel
08/08/2016 22:00,209,116,93,15,11,Klarer Himmel
08/08/2016 23:00,125,71,54,14,7,Klarer Himmel
09/08/2016 00:00,71,29,42,14,7,Klarer Himmel
09/08/2016 01:00,22,12,10,14,6,Klarer Himmel
09/08/2016 02:00,21,4,17,13,6,Klarer Himmel
09/08/2016 03:00,11,2,9,13,6,Klarer Himmel
09/08/2016 04:00,15,4,11,13,6,Klarer Himmel
09/08/2016 05:00,77,36,41,13,6,Klarer Himmel
09/08/2016 06:00,259,136,123,12,6,Klarer Himmel
09/08/2016 07:00,563,336,227,13,6,Klarer Himmel
09/08/2016 08:00,629,426,203,15,11,Klarer Himmel
09/08/2016 09:00,568,387,181,15,17,wolkig
09/08/2016 10:00,505,312,193,15,15,wolkig
09/08/2016 11:00,579,324,255,16,13,wolkig
09/08/2016 12:00,567,280,287,17,15,teilweise bewölkt
09/08/2016 13:00,583,257,326,18,19,teilweise bewölkt
09/08/2016 14:00,596,304,292,16,24,wolkig
09/08/2016 15:00,679,316,363,18,17,wolkig
09/08/2016 16:00,819,350,469,17,17,wolkig
09/08/2016 17:00,920,467,453,16,17,wolkig
09/08/2016 18:00,832,353,479,16,11,wolkig
09/08/2016 19:00,636,279,357,16,15,teilweise bewölkt
09/08/2016 20:00,427,190,237,13,4,wolkig
09/08/2016 21:00,297,153,144,14,7,Klarer Himmel
09/08/2016 22:00,244,128,116,13,7,Klarer Himmel
09/08/2016 23:00,140,62,78,13,9,Regen
10/08/2016 00:00,68,40,28,13,6,wolkig
10/08/2016 01:00,35,21,14,12,9,wolkig
10/08/2016 02:00,13,5,8,12,7,Regen
10/08/2016 03:00,12,6,6,11,7,Regen
10/08/2016 04:00,18,4,14,11,6,Regen
10/08/2016 05:00,59,36,23,10,7,Regen
10/08/2016 06:00,240,122,118,10,7,Klarer Himmel
10/08/2016 07:00,493,275,218,11,7,wolkig
10/08/2016 08:00,651,442,209,12,15,teilweise bewölkt
10/08/2016 09:00,551,407,144,13,13,teilweise bewölkt
10/08/2016 10:00,604,394,210,14,17,teilweise bewölkt
10/08/2016 11:00,579,357,222,16,15,teilweise bewölkt
10/08/2016 12:00,670,327,343,17,22,Regen
10/08/2016 13:00,577,270,307,14,13,Regen
10/08/2016 14:00,577,249,328,15,20,Regen
10/08/2016 15:00,594,262,332,13,19,Regen
10/08/2016 16:00,688,268,420,13,7,Regen
10/08/2016 17:00,808,406,402,14,9,Regen
10/08/2016 18:00,687,276,411,15,9,teilweise bewölkt
10/08/2016 19:00,587,249,338,14,4,teilweise bewölkt
10/08/2016 20:00,373,164,209,12,2,Klarer Himmel
10/08/2016 21:00,268,137,131,10,2,Nebel
10/08/2016 22:00,204,101,103,9,4,Nebel
10/08/2016 23:00,155,75,80,8,2,Klarer Himmel
11/08/2016 00:00,88,47,41,8,2,Klarer Himmel
11/08/2016 01:00,74,27,47,7,0,Nebel
11/08/2016 02:00,42,9,33,7,2,Nebel
11/08/2016 03:00,40,21,19,6,0,Nebel
11/08/2016 04:00,34,17,17,6,4,Nebel
11/08/2016 05:00,90,53,37,6,4,Nebel
11/08/2016 06:00,241,108,133,7,4,Nebel
11/08/2016 07:00,496,302,194,9,6,Klarer Himmel
11/08/2016 08:00,584,413,171,10,11,Klarer Himmel
11/08/2016 09:00,470,344,126,11,13,Klarer Himmel
11/08/2016 10:00,447,281,166,13,15,Regen
11/08/2016 11:00,465,279,186,14,20,Regen
11/08/2016 12:00,504,259,245,14,19,wolkig
11/08/2016 13:00,503,245,258,15,19,Regen
11/08/2016 14:00,575,293,282,14,19,Regen
11/08/2016 15:00,595,245,350,13,28,Regen
11/08/2016 16:00,628,263,365,13,22,Regen
11/08/2016 17:00,720,344,376,13,20,Regen
11/08/2016 18:00,638,270,368,13,19,Regen
11/08/2016 19:00,456,198,258,13,17,Regen
11/08/2016 20:00,276,117,159,13,15,Regen
11/08/2016 21:00,174,76,98,13,17,Regen
11/08/2016 22:00,134,78,56,13,15,Regen
11/08/2016 23:00,88,40,48,14,15,Regen
12/08/2016 00:00,53,20,33,14,15,Regen
12/08/2016 01:00,56,27,29,14,15,Regen
12/08/2016 02:00,25,15,10,14,11,Regen
12/08/2016 03:00,23,16,7,15,15,Regen
12/08/2016 04:00,35,21,14,15,13,Regen
12/08/2016 05:00,89,54,35,16,13,Regen
12/08/2016 06:00,208,101,107,16,13,Regen
12/08/2016 07:00,403,249,154,17,13,Regen
12/08/2016 08:00,445,301,144,17,15,Regen
12/08/2016 09:00,360,247,113,17,15,Regen
12/08/2016 10:00,374,219,155,17,15,Regen
12/08/2016 11:00,371,215,156,18,19,Regen
12/08/2016 12:00,460,238,222,19,24,wolkig
12/08/2016 13:00,520,245,275,20,24,wolkig
12/08/2016 14:00,631,317,314,21,28,wolkig
12/08/2016 15:00,616,300,316,21,26,wolkig
12/08/2016 16:00,696,333,363,20,26,wolkig
12/08/2016 17:00,666,305,361,21,13,wolkig
12/08/2016 18:00,581,271,310,21,13,wolkig
12/08/2016 19:00,579,263,316,21,15,wolkig
12/08/2016 20:00,373,187,186,20,7,wolkig
12/08/2016 21:00,307,155,152,19,6,teilweise bewölkt
12/08/2016 22:00,249,107,142,17,7,teilweise bewölkt
12/08/2016 23:00,181,84,97,17,7,teilweise bewölkt
13/08/2016 00:00,170,93,77,17,9,teilweise bewölkt
13/08/2016 01:00,148,64,84,17,11,wolkig
13/08/2016 02:00,111,46,65,16,11,teilweise bewölkt
13/08/2016 03:00,69,36,33,16,11,teilweise bewölkt
13/08/2016 04:00,66,47,19,16,11,teilweise bewölkt
13/08/2016 05:00,57,34,23,16,11,Klarer Himmel
13/08/2016 06:00,79,45,34,16,11,Klarer Himmel
13/08/2016 07:00,104,56,48,16,15,wolkig
13/08/2016 08:00,190,108,82,17,17,wolkig
13/08/2016 09:00,401,260,141,17,15,wolkig
13/08/2016 10:00,605,399,206,18,20,wolkig
13/08/2016 11:00,750,491,259,18,26,wolkig
13/08/2016 12:00,718,382,336,19,22,wolkig
13/08/2016 13:00,694,357,337,20,24,wolkig
13/08/2016 14:00,630,279,351,21,24,wolkig
13/08/2016 15:00,597,284,313,20,24,wolkig
13/08/2016 16:00,606,266,340,22,20,wolkig
13/08/2016 17:00,517,230,287,21,13,wolkig
13/08/2016 18:00,539,212,327,21,19,wolkig
13/08/2016 19:00,482,229,253,20,13,wolkig
13/08/2016 20:00,356,187,169,20,17,wolkig
13/08/2016 21:00,238,128,110,19,11,Regen
13/08/2016 22:00,210,106,104,17,6,wolkig
13/08/2016 23:00,187,84,103,16,0,wolkig
14/08/2016 00:00,170,52,118,16,2,teilweise bewölkt
14/08/2016 01:00,163,71,92,15,0,wolkig
14/08/2016 02:00,118,60,58,15,0,Nebel
14/08/2016 03:00,91,53,38,15,2,Nebel
14/08/2016 04:00,56,36,20,15,4,Nebel
14/08/2016 05:00,47,37,10,15,2,Nebel
14/08/2016 06:00,39,23,16,15,4,Nebel
14/08/2016 07:00,43,17,26,15,0,Nebel
14/08/2016 08:00,72,35,37,17,4,wolkig
14/08/2016 09:00,139,109,30,18,4,wolkig
14/08/2016 10:00,215,128,87,19,7,wolkig
14/08/2016 11:00,313,183,130,19,9,teilweise bewölkt
14/08/2016 12:00,348,200,148,20,11,teilweise bewölkt
14/08/2016 13:00,331,175,156,21,15,wolkig
14/08/2016 14:00,440,245,195,22,6,teilweise bewölkt
14/08/2016 15:00,433,252,181,22,11,teilweise bewölkt
14/08/2016 16:00,488,275,213,22,7,teilweise bewölkt
14/08/2016 17:00,409,213,196,21,11,wolkig
14/08/2016 18:00,478,249,229,21,17,teilweise bewölkt
14/08/2016 19:00,403,210,193,19,11,teilweise bewölkt
14/08/2016 20:00,338,191,147,17,9,Klarer Himmel
14/08/2016 21:00,199,123,76,16,7,Klarer Himmel
14/08/2016 22:00,163,101,62,14,6,Klarer Himmel
14/08/2016 23:00,85,46,39,13,4,Klarer Himmel
15/08/2016 00:00,52,32,20,13,0,Nebel
15/08/2016 01:00,27,17,10,11,2,teilweise bewölkt
15/08/2016 02:00,10,3,7,12,2,wolkig
15/08/2016 03:00,7,3,4,13,2,Klarer Himmel
15/08/2016 04:00,17,6,11,13,4,Klarer Himmel
15/08/2016 05:00,67,35,32,13,4,Klarer Himmel
15/08/2016 06:00,266,150,116,13,0,Klarer Himmel
15/08/2016 07:00,567,360,207,14,2,Klarer Himmel
15/08/2016 08:00,675,447,228,16,7,teilweise bewölkt
15/08/2016 09:00,547,389,158,18,9,teilweise bewölkt
15/08/2016 10:00,541,326,215,18,9,wolkig
15/08/2016 11:00,595,344,251,19,7,wolkig
15/08/2016 12:00,555,307,248,20,15,wolkig
15/08/2016 13:00,575,291,284,19,13,wolkig
15/08/2016 14:00,665,324,341,20,17,wolkig
15/08/2016 15:00,754,371,383,20,13,teilweise bewölkt
15/08/2016 16:00,910,387,523,20,13,wolkig
15/08/2016 17:00,1041,487,554,19,13,wolkig
15/08/2016 18:00,877,394,483,20,15,teilweise bewölkt
15/08/2016 19:00,714,282,432,19,13,Klarer Himmel
15/08/2016 20:00,426,220,206,16,4,Klarer Himmel
15/08/2016 21:00,277,144,133,14,2,Klarer Himmel
15/08/2016 22:00,238,125,113,13,4,Klarer Himmel
15/08/2016 23:00,99,57,42,12,4,Klarer Himmel
16/08/2016 00:00,71,39,32,13,4,Klarer Himmel
16/08/2016 01:00,30,15,15,12,4,Klarer Himmel
16/08/2016 02:00,24,12,12,11,2,Klarer Himmel
16/08/2016 03:00,18,10,8,10,2,Nebel
16/08/2016 04:00,17,5,12,10,0,Nebel
16/08/2016 05:00,84,38,46,9,0,Nebel
16/08/2016 06:00,317,167,150,9,4,Nebel
16/08/2016 07:00,603,372,231,13,6,Klarer Himmel
16/08/2016 08:00,761,510,251,15,9,wolkig
16/08/2016 09:00,543,387,156,17,13,wolkig
16/08/2016 10:00,577,354,223,18,13,wolkig
16/08/2016 11:00,549,316,233,19,13,wolkig
16/08/2016 12:00,640,327,313,19,11,teilweise bewölkt
16/08/2016 13:00,660,353,307,19,11,teilweise bewölkt
16/08/2016 14:00,663,344,319,21,13,teilweise bewölkt
16/08/2016 15:00,851,414,437,20,19,teilweise bewölkt
16/08/2016 16:00,951,415,536,21,15,teilweise bewölkt
16/08/2016 17:00,1054,504,550,21,13,teilweise bewölkt
16/08/2016 18:00,933,420,513,20,15,teilweise bewölkt
16/08/2016 19:00,759,316,443,19,11,Klarer Himmel
16/08/2016 20:00,472,230,242,16,6,Klarer Himmel
16/08/2016 21:00,348,173,175,15,6,Klarer Himmel
16/08/2016 22:00,274,166,108,13,4,Klarer Himmel
16/08/2016 23:00,152,84,68,13,6,Klarer Himmel
17/08/2016 00:00,88,43,45,13,2,Klarer Himmel
17/08/2016 01:00,26,15,11,13,4,Klarer Himmel
17/08/2016 02:00,15,8,7,14,6,Klarer Himmel
17/08/2016 03:00,12,6,6,13,4,Klarer Himmel
17/08/2016 04:00,21,9,12,11,4,Klarer Himmel
17/08/2016 05:00,75,38,37,9,2,Nebel
17/08/2016 06:00,297,158,139,8,6,Nebel
17/08/2016 07:00,649,383,266,12,2,Nebel
17/08/2016 08:00,767,539,228,15,7,Klarer Himmel
17/08/2016 09:00,666,457,209,17,7,Klarer Himmel
17/08/2016 10:00,662,452,210,19,9,Klarer Himmel
17/08/2016 11:00,756,453,303,20,9,Klarer Himmel
17/08/2016 12:00,823,422,401,21,11,Klarer Himmel
17/08/2016 13:00,782,356,426,21,9,Klarer Himmel
17/08/2016 14:00,766,344,422,22,11,Klarer Himmel
17/08/2016 15:00,815,382,433,22,9,Klarer Himmel
17/08/2016 16:00,969,411,558,22,11,Klarer Himmel
17/08/2016 17:00,1075,517,558,22,11,Klarer Himmel
17/08/2016 18:00,986,452,534,21,7,Klarer Himmel
17/08/2016 19:00,734,323,411,20,6,Klarer Himmel
17/08/2016 20:00,529,250,279,17,6,Klarer Himmel
17/08/2016 21:00,341,176,165,16,6,Klarer Himmel
17/08/2016 22:00,317,176,141,14,4,Klarer Himmel
17/08/2016 23:00,171,100,71,13,6,Klarer Himmel
18/08/2016 00:00,109,62,47,12,4,Klarer Himmel
18/08/2016 01:00,50,19,31,10,4,Nebel
18/08/2016 02:00,33,14,19,10,6,Nebel
18/08/2016 03:00,30,14,16,10,7,Nebel
18/08/2016 04:00,26,10,16,9,4,Klarer Himmel
18/08/2016 05:00,94,51,43,8,2,Nebel
18/08/2016 06:00,287,139,148,8,2,Nebel
18/08/2016 07:00,608,367,241,11,6,Klarer Himmel
18/08/2016 08:00,696,469,227,16,6,Klarer Himmel
18/08/2016 09:00,562,387,175,19,7,Klarer Himmel
18/08/2016 10:00,583,340,243,20,11,Klarer Himmel
18/08/2016 11:00,582,359,223,22,13,Klarer Himmel
18/08/2016 12:00,623,331,292,22,13,Klarer Himmel
18/08/2016 13:00,678,321,357,23,9,Klarer Himmel
18/08/2016 14:00,702,349,353,23,7,Klarer Himmel
18/08/2016 15:00,855,384,471,24,6,Klarer Himmel
18/08/2016 16:00,998,477,521,24,7,Klarer Himmel
18/08/2016 17:00,1034,466,568,24,13,Klarer Himmel
18/08/2016 18:00,964,468,496,23,11,Klarer Himmel
18/08/2016 19:00,737,353,384,22,6,Klarer Himmel
18/08/2016 20:00,495,224,271,18,6,Klarer Himmel
18/08/2016 21:00,341,162,179,15,2,Klarer Himmel
18/08/2016 22:00,341,199,142,15,7,Klarer Himmel
18/08/2016 23:00,164,101,63,15,4,Klarer Himmel
19/08/2016 00:00,99,60,39,14,4,Klarer Himmel
19/08/2016 01:00,51,27,24,14,4,Klarer Himmel
19/08/2016 02:00,21,12,9,12,4,Klarer Himmel
19/08/2016 03:00,11,4,7,11,2,Nebel
19/08/2016 04:00,19,7,12,10,0,Nebel
19/08/2016 05:00,67,30,37,9,0,Nebel
19/08/2016 06:00,259,147,112,9,0,Nebel
19/08/2016 07:00,547,334,213,11,2,Klarer Himmel
19/08/2016 08:00,634,413,221,16,4,Klarer Himmel
19/08/2016 09:00,561,382,179,19,6,Klarer Himmel
19/08/2016 10:00,514,334,180,21,4,Klarer Himmel
19/08/2016 11:00,614,351,263,22,6,teilweise bewölkt
19/08/2016 12:00,710,357,353,23,6,teilweise bewölkt
19/08/2016 13:00,829,363,466,25,7,Klarer Himmel
19/08/2016 14:00,859,416,443,26,6,Klarer Himmel
19/08/2016 15:00,806,378,428,25,7,Klarer Himmel
19/08/2016 16:00,862,403,459,26,7,Klarer Himmel
19/08/2016 17:00,882,441,441,25,6,Klarer Himmel
19/08/2016 18:00,745,348,397,23,4,Klarer Himmel
19/08/2016 19:00,572,273,299,22,4,Klarer Himmel
19/08/2016 20:00,408,196,212,19,2,Regen
19/08/2016 21:00,296,141,155,18,4,
19/08/2016 22:00,236,129,107,18,4,Klarer Himmel
19/08/2016 23:00,207,88,119,19,6,Regen
20/08/2016 00:00,140,77,63,19,20,Regen
20/08/2016 01:00,134,65,69,18,9,wolkig
20/08/2016 02:00,90,53,37,17,7,Klarer Himmel
20/08/2016 03:00,65,36,29,17,9,wolkig
20/08/2016 04:00,34,20,14,17,11,wolkig
20/08/2016 05:00,57,38,19,17,13,wolkig
20/08/2016 06:00,73,44,29,17,11,wolkig
20/08/2016 07:00,162,106,56,17,9,wolkig
20/08/2016 08:00,246,165,81,18,15,wolkig
20/08/2016 09:00,447,314,133,18,15,wolkig
20/08/2016 10:00,631,438,193,20,13,wolkig
20/08/2016 11:00,716,452,264,20,11,wolkig
20/08/2016 12:00,831,446,385,20,13,wolkig
20/08/2016 13:00,742,351,391,22,17,wolkig
20/08/2016 14:00,709,315,394,21,13,wolkig
20/08/2016 15:00,661,302,359,22,17,Regen
20/08/2016 16:00,567,221,346,20,9,teilweise bewölkt
20/08/2016 17:00,584,268,316,22,11,teilweise bewölkt
20/08/2016 18:00,534,201,333,22,11,teilweise bewölkt
20/08/2016 19:00,504,242,262,21,7,Klarer Himmel
20/08/2016 20:00,372,176,196,18,7,Klarer Himmel
20/08/2016 21:00,280,145,135,15,4,Nebel
20/08/2016 22:00,217,128,89,15,7,Klarer Himmel
20/08/2016 23:00,210,106,104,18,19,Klarer Himmel
21/08/2016 00:00,203,108,95,17,13,Klarer Himmel
21/08/2016 01:00,178,89,89,17,9,Klarer Himmel
21/08/2016 02:00,106,49,57,15,9,Klarer Himmel
21/08/2016 03:00,74,45,29,15,11,Klarer Himmel
21/08/2016 04:00,53,38,15,15,13,Klarer Himmel
21/08/2016 05:00,41,29,12,14,11,Klarer Himmel
21/08/2016 06:00,51,31,20,15,11,Klarer Himmel
21/08/2016 07:00,53,27,26,16,17,wolkig
21/08/2016 08:00,75,35,40,17,19,wolkig
21/08/2016 09:00,118,60,58,18,22,wolkig
21/08/2016 10:00,216,106,110,17,20,wolkig
21/08/2016 11:00,190,89,101,15,28,Regen
21/08/2016 12:00,216,110,106,17,22,wolkig
21/08/2016 13:00,263,135,128,17,20,wolkig
21/08/2016 14:00,285,168,117,19,20,wolkig
21/08/2016 15:00,281,149,132,18,20,Regen
21/08/2016 16:00,257,131,126,18,17,wolkig
21/08/2016 17:00,345,201,144,18,19,wolkig
21/08/2016 18:00,337,166,171,18,24,wolkig
21/08/2016 19:00,307,169,138,18,22,wolkig
21/08/2016 20:00,214,121,93,17,13,wolkig
21/08/2016 21:00,174,111,63,17,17,wolkig
21/08/2016 22:00,110,61,49,16,9,teilweise bewölkt
21/08/2016 23:00,53,36,17,16,11,teilweise bewölkt
22/08/2016 00:00,40,29,11,16,11,Klarer Himmel
22/08/2016 01:00,23,11,12,16,11,Klarer Himmel
22/08/2016 02:00,5,3,2,15,9,wolkig
22/08/2016 03:00,4,3,1,16,11,wolkig
22/08/2016 04:00,12,4,8,15,13,teilweise bewölkt
22/08/2016 05:00,89,44,45,14,11,wolkig
22/08/2016 06:00,308,144,164,14,9,Regen
22/08/2016 07:00,607,356,251,15,11,Regen
22/08/2016 08:00,652,435,217,15,13,Regen
22/08/2016 09:00,566,358,208,15,13,wolkig
22/08/2016 10:00,419,256,163,16,15,Regen
22/08/2016 11:00,398,227,171,16,17,Regen
22/08/2016 12:00,407,213,194,16,15,Regen
22/08/2016 13:00,438,221,217,16,13,Regen
22/08/2016 14:00,483,235,248,17,13,Regen
22/08/2016 15:00,615,303,312,17,13,Regen
22/08/2016 16:00,721,312,409,18,15,Regen
22/08/2016 17:00,832,395,437,18,11,Regen
22/08/2016 18:00,761,366,395,19,11,wolkig
22/08/2016 19:00,565,241,324,19,9,teilweise bewölkt
22/08/2016 20:00,353,153,200,18,9,Klarer Himmel
22/08/2016 21:00,240,123,117,17,7,Klarer Himmel
22/08/2016 22:00,207,115,92,17,7,teilweise bewölkt
22/08/2016 23:00,133,81,52,15,2,Nebel
23/08/2016 00:00,69,25,44,14,0,Nebel
23/08/2016 01:00,36,14,22,15,0,wolkig
23/08/2016 02:00,15,11,4,15,2,wolkig
23/08/2016 03:00,26,19,7,16,4,wolkig
23/08/2016 04:00,27,17,10,16,2,Klarer Himmel
23/08/2016 05:00,97,48,49,15,6,wolkig
23/08/2016 06:00,344,174,170,15,0,Nebel
23/08/2016 07:00,723,421,302,16,0,Nebel
23/08/2016 08:00,826,574,252,18,6,wolkig
23/08/2016 09:00,626,410,216,19,7,wolkig
23/08/2016 10:00,674,426,248,21,7,Klarer Himmel
23/08/2016 11:00,666,399,267,23,7,Klarer Himmel
23/08/2016 12:00,793,429,364,24,7,Klarer Himmel
23/08/2016 13:00,766,365,401,25,7,Klarer Himmel
23/08/2016 14:00,811,427,384,26,7,wolkig
23/08/2016 15:00,872,398,474,26,2,teilweise bewölkt
23/08/2016 16:00,1043,461,582,26,6,teilweise bewölkt
23/08/2016 17:00,1203,599,604,27,4,teilweise bewölkt
23/08/2016 18:00,1046,494,552,26,6,Klarer Himmel
23/08/2016 19:00,809,380,429,25,4,Klarer Himmel
23/08/2016 20:00,560,280,280,22,6,Klarer Himmel
23/08/2016 21:00,345,181,164,21,6,Klarer Himmel
23/08/2016 22:00,309,183,126,20,6,Klarer Himmel
23/08/2016 23:00,164,99,65,20,4,Klarer Himmel
24/08/2016 00:00,72,37,35,19,4,Klarer Himmel
24/08/2016 01:00,25,14,11,19,6,Klarer Himmel
24/08/2016 02:00,17,7,10,18,4,Klarer Himmel
24/08/2016 03:00,13,8,5,19,6,Klarer Himmel
24/08/2016 04:00,17,3,14,18,6,Klarer Himmel
24/08/2016 05:00,104,51,53,17,4,Klarer Himmel
24/08/2016 06:00,382,191,191,17,4,Klarer Himmel
24/08/2016 07:00,1084,717,367,19,7,Klarer Himmel
24/08/2016 08:00,950,653,297,21,7,Klarer Himmel
24/08/2016 09:00,709,505,204,23,6,Klarer Himmel
24/08/2016 10:00,712,434,278,25,7,Klarer Himmel
24/08/2016 11:00,741,411,330,27,7,Klarer Himmel
24/08/2016 12:00,751,356,395,28,9,Klarer Himmel
24/08/2016 13:00,935,351,584,29,11,Klarer Himmel
24/08/2016 14:00,837,330,507,30,13,Klarer Himmel
24/08/2016 15:00,939,434,505,30,11,Klarer Himmel
24/08/2016 16:00,1087,459,628,31,6,Klarer Himmel
24/08/2016 17:00,1142,565,577,31,6,Klarer Himmel
24/08/2016 18:00,998,477,521,30,4,Klarer Himmel
24/08/2016 19:00,845,421,424,28,6,Klarer Himmel
24/08/2016 20:00,641,327,314,25,6,Klarer Himmel
24/08/2016 21:00,436,243,193,24,6,Klarer Himmel
24/08/2016 22:00,339,192,147,25,7,Klarer Himmel
24/08/2016 23:00,247,145,102,23,6,Klarer Himmel
25/08/2016 00:00,96,76,20,21,4,Klarer Himmel
25/08/2016 01:00,71,30,41,21,6,Klarer Himmel
25/08/2016 02:00,40,21,19,21,9,Klarer Himmel
25/08/2016 03:00,28,16,12,21,7,Klarer Himmel
25/08/2016 04:00,23,11,12,19,4,Klarer Himmel
25/08/2016 05:00,88,44,44,20,9,Klarer Himmel
25/08/2016 06:00,347,162,185,19,9,Klarer Himmel
25/08/2016 07:00,1073,725,348,20,9,Klarer Himmel
25/08/2016 08:00,859,573,286,22,6,Klarer Himmel
25/08/2016 09:00,692,452,240,24,7,Klarer Himmel
25/08/2016 10:00,592,365,227,27,11,Klarer Himmel
25/08/2016 11:00,574,343,231,28,15,Klarer Himmel
25/08/2016 12:00,731,348,383,29,15,Klarer Himmel
25/08/2016 13:00,828,354,474,30,9,Klarer Himmel
25/08/2016 14:00,813,380,433,31,11,Klarer Himmel
25/08/2016 15:00,885,371,514,31,15,Klarer Himmel
25/08/2016 16:00,1100,486,614,32,11,Klarer Himmel
25/08/2016 17:00,1150,554,596,32,6,Klarer Himmel
25/08/2016 18:00,1017,478,539,32,4,Klarer Himmel
25/08/2016 19:00,874,456,418,29,4,Klarer Himmel
25/08/2016 20:00,628,342,286,24,0,Klarer Himmel
25/08/2016 21:00,456,232,224,21,4,Klarer Himmel
25/08/2016 22:00,392,207,185,20,2,Klarer Himmel
25/08/2016 23:00,222,142,80,21,6,Klarer Himmel
26/08/2016 00:00,98,52,46,19,2,Klarer Himmel
26/08/2016 01:00,63,37,26,18,2,Klarer Himmel
26/08/2016 02:00,31,15,16,20,6,Klarer Himmel
26/08/2016 03:00,11,7,4,20,6,Klarer Himmel
26/08/2016 04:00,17,7,10,19,6,Klarer Himmel
26/08/2016 05:00,92,49,43,18,4,Klarer Himmel
26/08/2016 06:00,314,157,157,18,2,Klarer Himmel
26/08/2016 07:00,1022,702,320,20,6,Klarer Himmel
26/08/2016 08:00,749,490,259,22,9,Klarer Himmel
26/08/2016 09:00,680,423,257,25,7,Klarer Himmel
26/08/2016 10:00,595,356,239,26,7,Klarer Himmel
26/08/2016 11:00,677,361,316,28,7,Klarer Himmel
26/08/2016 12:00,782,332,450,30,11,Klarer Himmel
26/08/2016 13:00,952,390,562,30,7,Klarer Himmel
26/08/2016 14:00,968,436,532,30,15,Klarer Himmel
26/08/2016 15:00,918,424,494,31,9,Klarer Himmel
26/08/2016 16:00,891,384,507,31,9,Klarer Himmel
26/08/2016 17:00,876,422,454,30,15,Klarer Himmel
26/08/2016 18:00,812,380,432,29,11,Klarer Himmel
26/08/2016 19:00,740,378,362,27,13,Klarer Himmel
26/08/2016 20:00,503,253,250,25,15,Klarer Himmel
26/08/2016 21:00,429,216,213,24,17,Klarer Himmel
26/08/2016 22:00,318,175,143,22,13,Klarer Himmel
26/08/2016 23:00,283,161,122,21,13,Klarer Himmel
27/08/2016 00:00,223,130,93,20,9,wolkig
27/08/2016 01:00,164,100,64,20,9,Klarer Himmel
27/08/2016 02:00,106,69,37,19,9,wolkig
27/08/2016 03:00,81,45,36,19,9,wolkig
27/08/2016 04:00,61,46,15,18,11,teilweise bewölkt
27/08/2016 05:00,54,34,20,17,7,wolkig
27/08/2016 06:00,74,38,36,17,9,teilweise bewölkt
27/08/2016 07:00,174,107,67,18,6,Klarer Himmel
27/08/2016 08:00,277,158,119,19,15,Klarer Himmel
27/08/2016 09:00,549,365,184,21,11,Klarer Himmel
27/08/2016 10:00,726,458,268,22,13,Klarer Himmel
27/08/2016 11:00,764,461,303,24,13,Klarer Himmel
27/08/2016 12:00,849,413,436,25,15,Klarer Himmel
27/08/2016 13:00,793,365,428,26,11,Klarer Himmel
27/08/2016 14:00,760,329,431,27,11,Klarer Himmel
27/08/2016 15:00,693,305,388,28,11,Klarer Himmel
27/08/2016 16:00,609,280,329,28,19,teilweise bewölkt
27/08/2016 17:00,623,299,324,29,9,teilweise bewölkt
27/08/2016 18:00,678,369,309,28,7,wolkig
27/08/2016 19:00,612,338,274,27,6,wolkig
27/08/2016 20:00,479,268,211,25,7,Klarer Himmel
27/08/2016 21:00,358,179,179,25,6,wolkig
27/08/2016 22:00,375,180,195,23,7,wolkig
27/08/2016 23:00,179,68,111,23,13,teilweise bewölkt
28/08/2016 00:00,226,83,143,24,7,teilweise bewölkt
28/08/2016 01:00,180,72,108,24,13,wolkig
28/08/2016 02:00,106,63,43,21,4,teilweise bewölkt
28/08/2016 03:00,104,70,34,21,6,wolkig
28/08/2016 04:00,62,43,19,21,6,Klarer Himmel
28/08/2016 05:00,40,35,5,20,7,Klarer Himmel
28/08/2016 06:00,49,22,27,20,4,Klarer Himmel
28/08/2016 07:00,67,26,41,21,9,Klarer Himmel
28/08/2016 08:00,84,45,39,23,9,Klarer Himmel
28/08/2016 09:00,200,126,74,25,11,teilweise bewölkt
28/08/2016 10:00,281,172,109,27,13,wolkig
28/08/2016 11:00,330,184,146,29,13,wolkig
28/08/2016 12:00,383,204,179,31,20,teilweise bewölkt
28/08/2016 13:00,407,185,222,32,22,teilweise bewölkt
28/08/2016 14:00,508,239,269,30,30,teilweise bewölkt
28/08/2016 15:00,454,233,221,27,32,Regen
28/08/2016 16:00,408,214,194,26,32,teilweise bewölkt
28/08/2016 17:00,477,259,218,25,33,teilweise bewölkt
28/08/2016 18:00,526,318,208,23,30,teilweise bewölkt
28/08/2016 19:00,387,215,172,22,26,teilweise bewölkt
28/08/2016 20:00,333,183,150,21,9,Klarer Himmel
28/08/2016 21:00,247,136,111,19,11,Klarer Himmel
28/08/2016 22:00,186,126,60,19,13,teilweise bewölkt
28/08/2016 23:00,93,54,39,18,6,Klarer Himmel
29/08/2016 00:00,46,26,20,17,9,teilweise bewölkt
29/08/2016 01:00,28,12,16,18,7,Klarer Himmel
29/08/2016 02:00,12,7,5,17,13,Klarer Himmel
29/08/2016 03:00,7,3,4,17,17,teilweise bewölkt
29/08/2016 04:00,9,3,6,17,15,wolkig
29/08/2016 05:00,85,45,40,17,13,wolkig
29/08/2016 06:00,307,140,167,17,19,Regen
29/08/2016 07:00,862,574,288,17,17,wolkig
29/08/2016 08:00,689,462,227,17,17,wolkig
29/08/2016 09:00,542,354,188,19,17,wolkig
29/08/2016 10:00,470,300,170,18,13,wolkig
29/08/2016 11:00,552,306,246,20,13,wolkig
29/08/2016 12:00,554,274,280,20,13,wolkig
29/08/2016 13:00,725,392,333,21,17,wolkig
29/08/2016 14:00,704,343,361,21,22,wolkig
29/08/2016 15:00,770,412,358,21,15,wolkig
29/08/2016 16:00,926,419,507,20,15,wolkig
29/08/2016 17:00,1049,482,567,21,15,teilweise bewölkt
29/08/2016 18:00,908,408,500,20,11,teilweise bewölkt
29/08/2016 19:00,666,287,379,19,15,wolkig
29/08/2016 20:00,428,212,216,17,9,teilweise bewölkt
29/08/2016 21:00,297,137,160,16,11,Klarer Himmel
29/08/2016 22:00,215,99,116,14,4,Klarer Himmel
29/08/2016 23:00,101,59,42,12,0,Klarer Himmel
30/08/2016 00:00,49,28,21,11,2,Klarer Himmel
30/08/2016 01:00,30,18,12,11,0,Nebel
30/08/2016 02:00,9,4,5,10,0,Nebel
30/08/2016 03:00,13,6,7,9,0,Nebel
30/08/2016 04:00,13,4,9,9,0,Nebel
30/08/2016 05:00,84,42,42,8,2,Nebel
30/08/2016 06:00,342,170,172,9,0,Nebel
30/08/2016 07:00,1062,694,368,10,2,Nebel
30/08/2016 08:00,901,600,301,14,0,Klarer Himmel
30/08/2016 09:00,641,423,218,17,0,Klarer Himmel
30/08/2016 10:00,576,355,221,18,2,teilweise bewölkt
30/08/2016 11:00,581,336,245,19,4,teilweise bewölkt
30/08/2016 12:00,774,400,374,20,6,teilweise bewölkt
30/08/2016 13:00,809,378,431,21,9,teilweise bewölkt
30/08/2016 14:00,832,422,410,22,7,Klarer Himmel
30/08/2016 15:00,928,447,481,22,7,Klarer Himmel
30/08/2016 16:00,1079,500,579,23,4,Klarer Himmel
30/08/2016 17:00,1220,574,646,22,6,Klarer Himmel
30/08/2016 18:00,1061,470,591,22,4,Klarer Himmel
30/08/2016 19:00,752,320,432,20,4,Klarer Himmel
30/08/2016 20:00,546,254,292,17,2,Klarer Himmel
30/08/2016 21:00,374,186,188,14,4,Klarer Himmel
30/08/2016 22:00,295,163,132,13,2,Klarer Himmel
30/08/2016 23:00,129,66,63,12,0,Klarer Himmel
31/08/2016 00:00,81,51,30,12,0,Klarer Himmel
31/08/2016 01:00,24,12,12,11,0,Klarer Himmel
31/08/2016 02:00,12,8,4,11,2,Klarer Himmel
31/08/2016 03:00,4,3,1,10,2,Klarer Himmel
31/08/2016 04:00,10,1,9,12,6,Klarer Himmel
31/08/2016 05:00,95,40,55,11,2,Klarer Himmel
31/08/2016 06:00,345,175,170,11,2,Klarer Himmel
31/08/2016 07:00,1106,710,396,13,4,Klarer Himmel
31/08/2016 08:00,940,645,295,16,4,Klarer Himmel
31/08/2016 09:00,709,470,239,18,7,Klarer Himmel
31/08/2016 10:00,664,406,258,20,9,Klarer Himmel
31/08/2016 11:00,680,372,308,22,4,Klarer Himmel
31/08/2016 12:00,834,415,419,24,4,Klarer Himmel
31/08/2016 13:00,936,423,513,25,9,Klarer Himmel
31/08/2016 14:00,900,404,496,26,11,Klarer Himmel
31/08/2016 15:00,972,449,523,26,13,Klarer Himmel
31/08/2016 16:00,1039,450,589,26,13,Klarer Himmel
31/08/2016 17:00,1208,563,645,26,19,Klarer Himmel
31/08/2016 18:00,1049,487,562,25,13,Klarer Himmel
31/08/2016 19:00,834,405,429,23,6,Klarer Himmel
31/08/2016 20:00,550,270,280,18,0,Klarer Himmel
31/08/2016 21:00,425,202,223,18,7,Klarer Himmel
31/08/2016 22:00,325,187,138,16,2,Klarer Himmel
31/08/2016 23:00,150,81,69,15,0,Klarer Himmel
01/09/2016 00:00,117,62,55,14,2,Klarer Himmel
01/09/2016 01:00,58,24,34,13,0,Klarer Himmel
01/09/2016 02:00,33,17,16,13,2,
01/09/2016 03:00,19,6,13,12,2,Nebel
01/09/2016 04:00,22,10,12,12,2,Nebel
01/09/2016 05:00,98,50,48,12,0,Nebel
01/09/2016 06:00,349,168,181,12,2,Nebel
01/09/2016 07:00,1050,703,347,13,0,Nebel
01/09/2016 08:00,894,595,299,16,0,
01/09/2016 09:00,656,422,234,18,6,
01/09/2016 10:00,564,377,187,20,6,Klarer Himmel
01/09/2016 11:00,641,372,269,23,13,teilweise bewölkt
01/09/2016 12:00,722,356,366,23,15,teilweise bewölkt
01/09/2016 13:00,870,405,465,24,17,teilweise bewölkt
01/09/2016 14:00,861,408,453,24,19,wolkig
01/09/2016 15:00,953,423,530,19,26,Regen
01/09/2016 16:00,1024,481,543,19,6,wolkig
01/09/2016 17:00,1095,521,574,20,7,wolkig
01/09/2016 18:00,1027,482,545,21,9,wolkig
01/09/2016 19:00,831,376,455,19,2,wolkig
01/09/2016 20:00,526,232,294,16,0,Nebel
01/09/2016 21:00,361,164,197,16,0,wolkig
01/09/2016 22:00,311,141,170,15,0,Nebel
01/09/2016 23:00,190,114,76,13,4,Nebel
02/09/2016 00:00,79,39,40,13,0,Nebel
02/09/2016 01:00,24,10,14,12,0,Nebel
02/09/2016 02:00,14,5,9,11,0,Nebel
02/09/2016 03:00,10,4,6,11,0,Nebel
02/09/2016 04:00,14,7,7,11,0,Nebel
02/09/2016 05:00,67,28,39,10,0,Nebel
02/09/2016 06:00,322,157,165,11,0,Nebel
02/09/2016 07:00,994,680,314,11,2,Nebel
02/09/2016 08:00,820,532,288,13,6,Nebel
02/09/2016 09:00,593,383,210,15,4,wolkig
02/09/2016 10:00,530,331,199,18,7,wolkig
02/09/2016 11:00,715,378,337,21,17,wolkig
02/09/2016 12:00,804,432,372,23,17,wolkig
02/09/2016 13:00,944,445,499,24,15,wolkig
02/09/2016 14:00,941,457,484,24,17,Klarer Himmel
02/09/2016 15:00,922,434,488,25,19,Klarer Himmel
02/09/2016 16:00,942,458,484,25,19,Klarer Himmel
02/09/2016 17:00,1002,483,519,24,19,wolkig
02/09/2016 18:00,801,388,413,22,17,Klarer Himmel
02/09/2016 19:00,714,353,361,21,11,Klarer Himmel
02/09/2016 20:00,533,249,284,18,6,Klarer Himmel
02/09/2016 21:00,360,188,172,18,6,Klarer Himmel
02/09/2016 22:00,325,150,175,18,6,Klarer Himmel
02/09/2016 23:00,270,125,145,18,6,Klarer Himmel
03/09/2016 00:00,243,85,158,18,4,Klarer Himmel
03/09/2016 01:00,158,53,105,17,11,wolkig
03/09/2016 02:00,110,55,55,17,7,wolkig
03/09/2016 03:00,77,40,37,16,7,wolkig
03/09/2016 04:00,61,37,24,16,11,wolkig
03/09/2016 05:00,55,39,16,16,7,Klarer Himmel
03/09/2016 06:00,72,42,30,15,9,teilweise bewölkt
03/09/2016 07:00,140,91,49,16,7,wolkig
03/09/2016 08:00,247,144,103,17,11,wolkig
03/09/2016 09:00,450,320,130,18,11,wolkig
03/09/2016 10:00,642,424,218,18,19,wolkig
03/09/2016 11:00,716,455,261,18,13,wolkig
03/09/2016 12:00,760,410,350,20,17,wolkig
03/09/2016 13:00,788,396,392,20,11,wolkig
03/09/2016 14:00,789,387,402,21,20,wolkig
03/09/2016 15:00,747,373,374,22,17,wolkig
03/09/2016 16:00,679,310,369,22,15,wolkig
03/09/2016 17:00,711,334,377,22,13,wolkig
03/09/2016 18:00,727,337,390,22,6,wolkig
03/09/2016 19:00,731,404,327,19,0,wolkig
03/09/2016 20:00,563,297,266,17,0,wolkig
03/09/2016 21:00,434,203,231,16,6,Klarer Himmel
03/09/2016 22:00,416,157,259,17,7,Klarer Himmel
03/09/2016 23:00,380,129,251,18,9,Klarer Himmel
04/09/2016 00:00,293,106,187,18,9,Klarer Himmel
04/09/2016 01:00,246,112,134,18,13,Klarer Himmel
04/09/2016 02:00,160,76,84,19,11,wolkig
04/09/2016 03:00,104,65,39,19,11,wolkig
04/09/2016 04:00,71,39,32,18,7,Regen
04/09/2016 05:00,70,62,8,17,15,Regen
04/09/2016 06:00,46,28,18,17,15,Klarer Himmel
04/09/2016 07:00,48,20,28,17,13,wolkig
04/09/2016 08:00,79,32,47,18,19,wolkig
04/09/2016 09:00,117,60,57,18,15,wolkig
04/09/2016 10:00,212,108,104,19,15,wolkig
04/09/2016 11:00,210,129,81,19,20,Regen
04/09/2016 12:00,203,103,100,19,20,wolkig
04/09/2016 13:00,266,137,129,21,26,teilweise bewölkt
04/09/2016 14:00,304,158,146,22,26,teilweise bewölkt
04/09/2016 15:00,333,207,126,22,33,teilweise bewölkt
04/09/2016 16:00,377,204,173,20,24,wolkig
04/09/2016 17:00,422,198,224,19,32,wolkig
04/09/2016 18:00,329,151,178,19,32,wolkig
04/09/2016 19:00,360,214,146,18,22,wolkig
04/09/2016 20:00,246,136,110,17,20,wolkig
04/09/2016 21:00,147,83,64,16,20,Regen
04/09/2016 22:00,109,62,47,16,20,teilweise bewölkt
04/09/2016 23:00,81,46,35,17,17,wolkig
05/09/2016 00:00,34,21,13,16,15,wolkig
05/09/2016 01:00,17,12,5,16,22,wolkig
05/09/2016 02:00,5,2,3,16,24,wolkig
05/09/2016 03:00,0,0,0,16,24,Regen
05/09/2016 04:00,13,7,6,15,20,wolkig
05/09/2016 05:00,73,36,37,15,20,Regen
05/09/2016 06:00,315,144,171,15,19,Regen
05/09/2016 07:00,927,599,328,15,13,wolkig
05/09/2016 08:00,815,560,255,16,17,teilweise bewölkt
05/09/2016 09:00,581,380,201,17,13,wolkig
05/09/2016 10:00,488,313,175,18,19,wolkig
05/09/2016 11:00,539,312,227,19,15,wolkig
05/09/2016 12:00,604,298,306,20,11,wolkig
05/09/2016 13:00,717,347,370,22,9,wolkig
05/09/2016 14:00,733,394,339,22,13,wolkig
05/09/2016 15:00,859,407,452,22,11,wolkig
05/09/2016 16:00,943,435,508,22,11,teilweise bewölkt
05/09/2016 17:00,1130,491,639,22,11,teilweise bewölkt
05/09/2016 18:00,966,440,526,21,9,teilweise bewölkt
05/09/2016 19:00,757,350,407,19,6,teilweise bewölkt
05/09/2016 20:00,390,181,209,17,0,wolkig
05/09/2016 21:00,327,148,179,15,0,teilweise bewölkt
05/09/2016 22:00,266,148,118,15,0,Klarer Himmel
05/09/2016 23:00,95,47,48,13,2,Nebel
06/09/2016 00:00,55,22,33,13,0,Nebel
06/09/2016 01:00,39,21,18,12,0,Nebel
06/09/2016 02:00,14,3,11,12,0,Nebel
06/09/2016 03:00,9,6,3,11,0,Nebel
06/09/2016 04:00,14,7,7,12,2,Nebel
06/09/2016 05:00,93,39,54,11,0,Nebel
06/09/2016 06:00,375,178,197,11,0,Nebel
06/09/2016 07:00,1043,689,354,13,2,Nebel
06/09/2016 08:00,888,601,287,15,2,teilweise bewölkt
06/09/2016 09:00,594,425,169,17,7,teilweise bewölkt
06/09/2016 10:00,564,345,219,20,6,Klarer Himmel
06/09/2016 11:00,557,307,250,22,9,teilweise bewölkt
06/09/2016 12:00,701,368,333,23,11,teilweise bewölkt
06/09/2016 13:00,812,394,418,23,7,teilweise bewölkt
06/09/2016 14:00,848,388,460,24,9,teilweise bewölkt
06/09/2016 15:00,925,452,473,24,7,teilweise bewölkt
06/09/2016 16:00,1053,493,560,25,6,teilweise bewölkt
06/09/2016 17:00,1232,588,644,25,7,Klarer Himmel
06/09/2016 18:00,1111,529,582,24,2,Klarer Himmel
06/09/2016 19:00,809,377,432,19,4,Klarer Himmel
06/09/2016 20:00,513,259,254,18,0,Klarer Himmel
06/09/2016 21:00,388,192,196,16,2,Klarer Himmel
06/09/2016 22:00,289,157,132,15,2,Klarer Himmel
06/09/2016 23:00,145,74,71,14,0,Klarer Himmel
07/09/2016 00:00,79,44,35,13,0,Klarer Himmel
07/09/2016 01:00,36,19,17,13,4,Klarer Himmel
07/09/2016 02:00,19,12,7,15,4,Klarer Himmel
07/09/2016 03:00,8,2,6,15,6,Klarer Himmel
07/09/2016 04:00,15,4,11,14,4,Klarer Himmel
07/09/2016 05:00,86,41,45,13,6,Klarer Himmel
07/09/2016 06:00,373,179,194,13,2,Klarer Himmel
07/09/2016 07:00,1121,724,397,14,4,Klarer Himmel
07/09/2016 08:00,940,629,311,16,6,Klarer Himmel
07/09/2016 09:00,752,501,251,18,7,Klarer Himmel
07/09/2016 10:00,691,421,270,20,7,Klarer Himmel
07/09/2016 11:00,685,387,298,23,4,Klarer Himmel
07/09/2016 12:00,816,390,426,25,4,Klarer Himmel
07/09/2016 13:00,859,396,463,25,7,Klarer Himmel
07/09/2016 14:00,834,350,484,26,7,Klarer Himmel
07/09/2016 15:00,911,402,509,26,9,Klarer Himmel
07/09/2016 16:00,1072,460,612,27,6,Klarer Himmel
07/09/2016 17:00,1215,641,574,26,7,Klarer Himmel
07/09/2016 18:00,1050,500,550,25,7,Klarer Himmel
07/09/2016 19:00,838,428,410,23,4,Klarer Himmel
07/09/2016 20:00,610,270,340,19,6,Klarer Himmel
07/09/2016 21:00,467,222,245,18,6,Klarer Himmel
07/09/2016 22:00,314,167,147,16,6,Klarer Himmel
07/09/2016 23:00,181,90,91,18,4,Klarer Himmel
08/09/2016 00:00,87,44,43,16,4,Klarer Himmel
08/09/2016 01:00,47,19,28,14,0,Klarer Himmel
08/09/2016 02:00,29,15,14,14,4,Klarer Himmel
08/09/2016 03:00,21,10,11,16,6,Klarer Himmel
08/09/2016 04:00,29,12,17,16,4,Klarer Himmel
08/09/2016 05:00,92,43,49,14,2,Klarer Himmel
08/09/2016 06:00,368,167,201,13,2,Nebel
08/09/2016 07:00,1091,693,398,16,6,Klarer Himmel
08/09/2016 08:00,880,598,282,18,6,Klarer Himmel
08/09/2016 09:00,665,431,234,21,9,Klarer Himmel
08/09/2016 10:00,596,380,216,23,11,Klarer Himmel
08/09/2016 11:00,619,306,313,25,15,Klarer Himmel
08/09/2016 12:00,751,383,368,27,13,Klarer Himmel
08/09/2016 13:00,815,366,449,27,13,Klarer Himmel
08/09/2016 14:00,881,406,475,28,20,Klarer Himmel
08/09/2016 15:00,973,408,565,28,22,Klarer Himmel
08/09/2016 16:00,1130,526,604,28,17,Klarer Himmel
08/09/2016 17:00,1121,551,570,27,22,Klarer Himmel
08/09/2016 18:00,1137,598,539,26,11,Klarer Himmel
08/09/2016 19:00,861,400,461,22,4,Klarer Himmel
08/09/2016 20:00,573,257,316,20,0,Klarer Himmel
08/09/2016 21:00,400,198,202,19,0,Klarer Himmel
08/09/2016 22:00,350,202,148,17,0,Klarer Himmel
08/09/2016 23:00,188,128,60,19,9,Klarer Himmel
09/09/2016 00:00,107,62,45,19,9,Klarer Himmel
09/09/2016 01:00,41,20,21,18,9,teilweise bewölkt
09/09/2016 02:00,22,8,14,18,11,wolkig
09/09/2016 03:00,12,5,7,18,11,wolkig
09/09/2016 04:00,16,5,11,16,7,wolkig
09/09/2016 05:00,81,36,45,17,7,teilweise bewölkt
09/09/2016 06:00,317,154,163,15,6,Nebel
09/09/2016 07:00,998,653,345,16,9,wolkig
09/09/2016 08:00,768,503,265,16,9,wolkig
09/09/2016 09:00,561,382,179,16,7,wolkig
09/09/2016 10:00,557,363,194,18,7,wolkig
09/09/2016 11:00,591,326,265,18,7,wolkig
09/09/2016 12:00,711,362,349,20,9,teilweise bewölkt
09/09/2016 13:00,1028,448,580,21,7,teilweise bewölkt
09/09/2016 14:00,1017,524,493,23,9,teilweise bewölkt
09/09/2016 15:00,928,421,507,23,7,teilweise bewölkt
09/09/2016 16:00,936,440,496,24,6,teilweise bewölkt
09/09/2016 17:00,990,491,499,23,4,teilweise bewölkt
09/09/2016 18:00,859,398,461,23,6,Klarer Himmel
09/09/2016 19:00,748,359,389,19,4,Klarer Himmel
09/09/2016 20:00,524,227,297,16,0,Nebel
09/09/2016 21:00,377,164,213,15,0,Nebel
09/09/2016 22:00,360,162,198,14,0,Nebel
09/09/2016 23:00,304,168,136,13,0,Nebel
10/09/2016 00:00,227,130,97,12,0,Nebel
10/09/2016 01:00,186,122,64,12,0,Nebel
10/09/2016 02:00,125,71,54,11,0,Nebel
10/09/2016 03:00,90,55,35,10,0,Nebel
10/09/2016 04:00,45,26,19,10,0,Nebel
10/09/2016 05:00,77,49,28,10,0,Nebel
10/09/2016 06:00,63,39,24,10,0,Nebel
10/09/2016 07:00,167,95,72,11,0,Nebel
10/09/2016 08:00,265,163,102,15,0,Klarer Himmel
10/09/2016 09:00,525,367,158,18,4,Klarer Himmel
10/09/2016 10:00,707,488,219,21,2,Klarer Himmel
10/09/2016 11:00,868,527,341,23,4,Klarer Himmel
10/09/2016 12:00,912,509,403,24,6,Klarer Himmel
10/09/2016 13:00,966,458,508,26,7,Klarer Himmel
10/09/2016 14:00,857,391,466,26,9,Klarer Himmel
10/09/2016 15:00,737,332,405,27,11,Klarer Himmel
10/09/2016 16:00,737,318,419,26,11,Klarer Himmel
10/09/2016 17:00,664,317,347,27,11,Klarer Himmel
10/09/2016 18:00,697,325,372,26,7,Klarer Himmel
10/09/2016 19:00,580,299,281,23,6,Klarer Himmel
10/09/2016 20:00,470,219,251,20,4,Klarer Himmel
10/09/2016 21:00,351,176,175,18,4,Klarer Himmel
10/09/2016 22:00,353,154,199,17,0,Klarer Himmel
10/09/2016 23:00,242,116,126,16,0,Klarer Himmel
11/09/2016 00:00,229,119,110,15,0,Klarer Himmel
11/09/2016 01:00,171,88,83,15,0,Klarer Himmel
11/09/2016 02:00,120,57,63,14,0,Klarer Himmel
11/09/2016 03:00,94,52,42,13,0,Nebel
11/09/2016 04:00,68,46,22,13,0,Nebel
11/09/2016 05:00,59,40,19,12,0,Nebel
11/09/2016 06:00,49,35,14,13,2,Nebel
11/09/2016 07:00,81,46,35,13,0,Nebel
11/09/2016 08:00,285,220,65,15,0,Klarer Himmel
11/09/2016 09:00,246,167,79,18,4,Klarer Himmel
11/09/2016 10:00,369,230,139,21,0,Klarer Himmel
11/09/2016 11:00,425,247,178,22,6,Klarer Himmel
11/09/2016 12:00,539,324,215,23,6,Klarer Himmel
11/09/2016 13:00,618,279,339,24,6,wolkig
11/09/2016 14:00,723,274,449,24,6,wolkig
11/09/2016 15:00,564,243,321,24,6,wolkig
11/09/2016 16:00,551,283,268,25,6,wolkig
11/09/2016 17:00,553,273,280,25,6,wolkig
11/09/2016 18:00,513,289,224,24,4,wolkig
11/09/2016 19:00,452,257,195,21,0,Klarer Himmel
11/09/2016 20:00,308,173,135,18,4,Klarer Himmel
11/09/2016 21:00,234,136,98,17,4,Klarer Himmel
11/09/2016 22:00,213,105,108,17,4,Klarer Himmel
11/09/2016 23:00,87,48,39,16,2,Klarer Himmel
12/09/2016 00:00,39,25,14,16,0,Klarer Himmel
12/09/2016 01:00,21,13,8,15,0,Nebel
12/09/2016 02:00,7,6,1,14,0,Nebel
12/09/2016 03:00,4,1,3,14,4,Nebel
12/09/2016 04:00,20,7,13,14,2,Klarer Himmel
12/09/2016 05:00,86,37,49,13,0,Klarer Himmel
12/09/2016 06:00,351,163,188,13,2,Nebel
12/09/2016 07:00,1068,699,369,13,2,Klarer Himmel
12/09/2016 08:00,872,583,289,18,0,Klarer Himmel
12/09/2016 09:00,681,462,219,21,7,Klarer Himmel
12/09/2016 10:00,566,346,220,23,6,teilweise bewölkt
12/09/2016 11:00,578,341,237,25,4,Klarer Himmel
12/09/2016 12:00,684,336,348,28,4,Klarer Himmel
12/09/2016 13:00,845,412,433,29,4,Klarer Himmel
12/09/2016 14:00,839,400,439,30,7,Klarer Himmel
12/09/2016 15:00,932,379,553,30,6,Klarer Himmel
12/09/2016 16:00,1087,486,601,30,4,Klarer Himmel
12/09/2016 17:00,1133,527,606,31,2,Klarer Himmel
12/09/2016 18:00,1057,524,533,28,6,Klarer Himmel
12/09/2016 19:00,809,391,418,25,0,Klarer Himmel
12/09/2016 20:00,499,246,253,22,0,Klarer Himmel
12/09/2016 21:00,361,204,157,20,0,Klarer Himmel
12/09/2016 22:00,231,134,97,19,0,Klarer Himmel
12/09/2016 23:00,146,89,57,18,0,Klarer Himmel
13/09/2016 00:00,55,23,32,17,0,Klarer Himmel
13/09/2016 01:00,44,24,20,17,0,Klarer Himmel
13/09/2016 02:00,21,11,10,17,0,Klarer Himmel
13/09/2016 03:00,6,2,4,19,4,Nebel
13/09/2016 04:00,16,4,12,18,0,Klarer Himmel
13/09/2016 05:00,83,41,42,16,0,Klarer Himmel
13/09/2016 06:00,395,186,209,18,2,Klarer Himmel
13/09/2016 07:00,1096,713,383,19,2,Klarer Himmel
13/09/2016 08:00,914,605,309,22,2,Klarer Himmel
13/09/2016 09:00,651,446,205,23,7,Klarer Himmel
13/09/2016 10:00,551,351,200,25,9,Klarer Himmel
13/09/2016 11:00,627,332,295,28,7,Klarer Himmel
13/09/2016 12:00,777,345,432,30,7,Klarer Himmel
13/09/2016 13:00,774,349,425,31,9,Klarer Himmel
13/09/2016 14:00,834,371,463,32,9,Klarer Himmel
13/09/2016 15:00,919,384,535,33,9,Klarer Himmel
13/09/2016 16:00,1058,479,579,33,11,Klarer Himmel
13/09/2016 17:00,1219,611,608,32,6,Klarer Himmel
13/09/2016 18:00,1075,529,546,31,6,Klarer Himmel
13/09/2016 19:00,912,479,433,26,4,Klarer Himmel
13/09/2016 20:00,554,286,268,24,6,Klarer Himmel
13/09/2016 21:00,427,220,207,24,6,Klarer Himmel
13/09/2016 22:00,322,184,138,24,7,Klarer Himmel
13/09/2016 23:00,166,82,84,21,2,Klarer Himmel
14/09/2016 00:00,84,48,36,19,6,Klarer Himmel
14/09/2016 01:00,38,18,20,22,6,Klarer Himmel
14/09/2016 02:00,16,7,9,22,4,Klarer Himmel
14/09/2016 03:00,10,5,5,22,6,Klarer Himmel
14/09/2016 04:00,13,5,8,22,6,Klarer Himmel
14/09/2016 05:00,77,28,49,21,6,Klarer Himmel
14/09/2016 06:00,377,171,206,19,6,Klarer Himmel
14/09/2016 07:00,1139,733,406,20,6,Klarer Himmel
14/09/2016 08:00,918,614,304,21,4,Klarer Himmel
14/09/2016 09:00,724,494,230,23,4,Klarer Himmel
14/09/2016 10:00,666,417,249,26,9,Klarer Himmel
14/09/2016 11:00,732,391,341,29,9,Klarer Himmel
14/09/2016 12:00,817,353,464,30,9,Klarer Himmel
14/09/2016 13:00,908,391,517,31,9,Klarer Himmel
14/09/2016 14:00,825,370,455,31,6,Klarer Himmel
14/09/2016 15:00,903,369,534,32,9,Klarer Himmel
14/09/2016 16:00,1085,485,600,32,4,Klarer Himmel
14/09/2016 17:00,1146,607,539,31,6,Klarer Himmel
14/09/2016 18:00,1108,585,523,29,4,Klarer Himmel
14/09/2016 19:00,893,453,440,27,6,Klarer Himmel
14/09/2016 20:00,620,317,303,22,6,Klarer Himmel
14/09/2016 21:00,395,199,196,23,7,Klarer Himmel
14/09/2016 22:00,401,218,183,24,7,Klarer Himmel
14/09/2016 23:00,205,121,84,23,6,Klarer Himmel
15/09/2016 00:00,102,46,56,23,9,Klarer Himmel
15/09/2016 01:00,90,46,44,22,7,Klarer Himmel
15/09/2016 02:00,36,12,24,21,9,Klarer Himmel
15/09/2016 03:00,22,12,10,21,7,Klarer Himmel
15/09/2016 04:00,32,14,18,19,7,Klarer Himmel
15/09/2016 05:00,85,36,49,17,6,Klarer Himmel
15/09/2016 06:00,380,164,216,17,7,Klarer Himmel
15/09/2016 07:00,1119,755,364,18,4,Klarer Himmel
15/09/2016 08:00,857,581,276,20,6,Klarer Himmel
15/09/2016 09:00,706,465,241,22,9,Klarer Himmel
15/09/2016 10:00,540,326,214,24,11,Klarer Himmel
15/09/2016 11:00,643,337,306,25,11,Klarer Himmel
15/09/2016 12:00,710,320,390,27,11,Klarer Himmel
15/09/2016 13:00,868,422,446,29,13,Klarer Himmel
15/09/2016 14:00,847,401,446,29,13,Klarer Himmel
15/09/2016 15:00,981,417,564,29,17,Klarer Himmel
15/09/2016 16:00,1162,519,643,29,13,Klarer Himmel
15/09/2016 17:00,1208,564,644,28,15,Klarer Himmel
15/09/2016 18:00,1052,534,518,26,9,Klarer Himmel
15/09/2016 19:00,915,478,437,24,7,Klarer Himmel
15/09/2016 20:00,545,296,249,23,7,Klarer Himmel
15/09/2016 21:00,404,221,183,24,11,Klarer Himmel
15/09/2016 22:00,341,172,169,23,7,Klarer Himmel
15/09/2016 23:00,173,87,86,21,11,Klarer Himmel
16/09/2016 00:00,87,58,29,22,13,Klarer Himmel
16/09/2016 01:00,45,22,23,20,15,Klarer Himmel
16/09/2016 02:00,20,9,11,20,11,Klarer Himmel
16/09/2016 03:00,18,11,7,19,15,Regen
16/09/2016 04:00,17,6,11,18,19,Regen
16/09/2016 05:00,64,28,36,16,13,Regen
16/09/2016 06:00,286,135,151,16,7,wolkig
16/09/2016 07:00,909,598,311,15,6,wolkig
16/09/2016 08:00,712,472,240,16,6,
16/09/2016 09:00,561,379,182,18,9,wolkig
16/09/2016 10:00,530,323,207,18,11,wolkig
16/09/2016 11:00,637,336,301,19,15,wolkig
16/09/2016 12:00,702,332,370,20,17,teilweise bewölkt
16/09/2016 13:00,836,376,460,21,15,wolkig
16/09/2016 14:00,901,404,497,22,17,wolkig
16/09/2016 15:00,833,390,443,22,17,wolkig
16/09/2016 16:00,898,414,484,21,13,wolkig
16/09/2016 17:00,894,393,501,21,7,wolkig
16/09/2016 18:00,785,340,445,20,7,wolkig
16/09/2016 19:00,743,340,403,19,6,wolkig
16/09/2016 20:00,439,203,236,17,6,Klarer Himmel
16/09/2016 21:00,308,145,163,17,4,Klarer Himmel
16/09/2016 22:00,290,133,157,16,2,Klarer Himmel
16/09/2016 23:00,237,107,130,16,2,Klarer Himmel
17/09/2016 00:00,195,115,80,16,0,Klarer Himmel
17/09/2016 01:00,179,77,102,15,4,Klarer Himmel
17/09/2016 02:00,109,49,60,15,0,Klarer Himmel
17/09/2016 03:00,99,57,42,15,0,Klarer Himmel
17/09/2016 04:00,67,40,27,14,0,Klarer Himmel
17/09/2016 05:00,77,50,27,14,0,Klarer Himmel
17/09/2016 06:00,75,46,29,14,0,Klarer Himmel
17/09/2016 07:00,179,121,58,14,0,Nebel
17/09/2016 08:00,261,170,91,15,0,wolkig
17/09/2016 09:00,513,341,172,17,2,Klarer Himmel
17/09/2016 10:00,695,505,190,18,7,Klarer Himmel
17/09/2016 11:00,800,475,325,18,7,Regen
17/09/2016 12:00,743,384,359,18,11,Regen
17/09/2016 13:00,757,334,423,19,11,Regen
17/09/2016 14:00,715,281,434,19,9,Regen
17/09/2016 15:00,640,252,388,19,9,Regen
17/09/2016 16:00,599,234,365,19,11,wolkig
17/09/2016 17:00,543,249,294,19,7,wolkig
17/09/2016 18:00,522,231,291,19,6,wolkig
17/09/2016 19:00,516,234,282,19,2,wolkig
17/09/2016 20:00,329,147,182,18,7,Klarer Himmel
17/09/2016 21:00,249,133,116,18,9,wolkig
17/09/2016 22:00,197,115,82,18,13,Klarer Himmel
17/09/2016 23:00,192,93,99,17,7,Klarer Himmel
18/09/2016 00:00,161,88,73,17,15,Klarer Himmel
18/09/2016 01:00,183,76,107,16,11,wolkig
18/09/2016 02:00,123,61,62,16,19,wolkig
18/09/2016 03:00,105,67,38,16,17,wolkig
18/09/2016 04:00,82,53,29,16,17,wolkig
18/09/2016 05:00,38,26,12,16,15,wolkig
18/09/2016 06:00,49,33,16,15,11,wolkig
18/09/2016 07:00,57,30,27,15,11,wolkig
18/09/2016 08:00,74,39,35,14,17,wolkig
18/09/2016 09:00,168,111,57,15,17,
18/09/2016 10:00,268,166,102,16,15,wolkig
18/09/2016 11:00,294,175,119,17,17,teilweise bewölkt
18/09/2016 12:00,338,159,179,19,9,teilweise bewölkt
18/09/2016 13:00,378,205,173,19,13,teilweise bewölkt
18/09/2016 14:00,404,206,198,19,13,teilweise bewölkt
18/09/2016 15:00,490,254,236,19,19,teilweise bewölkt
18/09/2016 16:00,472,250,222,20,15,Klarer Himmel
18/09/2016 17:00,550,281,269,19,11,Klarer Himmel
18/09/2016 18:00,445,237,208,18,11,Klarer Himmel
18/09/2016 19:00,360,206,154,18,13,Klarer Himmel
18/09/2016 20:00,270,169,101,17,11,Klarer Himmel
18/09/2016 21:00,164,88,76,17,13,Klarer Himmel
18/09/2016 22:00,140,79,61,16,11,Klarer Himmel
18/09/2016 23:00,87,50,37,16,11,Klarer Himmel
19/09/2016 00:00,57,32,25,15,11,Klarer Himmel
19/09/2016 01:00,23,10,13,15,9,Klarer Himmel
19/09/2016 02:00,5,4,1,15,9,Klarer Himmel
19/09/2016 03:00,2,1,1,15,9,Klarer Himmel
19/09/2016 04:00,20,8,12,14,9,Klarer Himmel
19/09/2016 05:00,77,32,45,14,11,Klarer Himmel
19/09/2016 06:00,329,141,188,14,15,Klarer Himmel
19/09/2016 07:00,1044,700,344,12,13,Klarer Himmel
19/09/2016 08:00,846,565,281,14,11,Klarer Himmel
19/09/2016 09:00,670,452,218,15,19,Klarer Himmel
19/09/2016 10:00,553,327,226,16,17,Klarer Himmel
19/09/2016 11:00,611,340,271,16,15,teilweise bewölkt
19/09/2016 12:00,666,324,342,17,9,teilweise bewölkt
19/09/2016 13:00,780,369,411,17,6,teilweise bewölkt
19/09/2016 14:00,782,414,368,18,9,teilweise bewölkt
19/09/2016 15:00,831,383,448,18,6,wolkig
19/09/2016 16:00,974,441,533,18,4,wolkig
19/09/2016 17:00,1118,534,584,17,2,wolkig
19/09/2016 18:00,940,395,545,17,9,teilweise bewölkt
19/09/2016 19:00,786,365,421,16,4,teilweise bewölkt
19/09/2016 20:00,435,201,234,15,0,teilweise bewölkt
19/09/2016 21:00,320,158,162,14,0,Klarer Himmel
19/09/2016 22:00,217,122,95,14,0,Klarer Himmel
19/09/2016 23:00,113,66,47,14,0,Klarer Himmel
20/09/2016 00:00,68,30,38,14,4,Klarer Himmel
20/09/2016 01:00,35,11,24,14,0,Klarer Himmel
20/09/2016 02:00,22,9,13,13,0,Klarer Himmel
20/09/2016 03:00,6,2,4,13,0,Klarer Himmel
20/09/2016 04:00,16,6,10,13,0,Klarer Himmel
20/09/2016 05:00,90,31,59,13,0,wolkig
20/09/2016 06:00,372,160,212,13,0,Klarer Himmel
20/09/2016 07:00,1045,700,345,13,0,Klarer Himmel
20/09/2016 08:00,922,616,306,14,0,Klarer Himmel
20/09/2016 09:00,640,446,194,14,4,Klarer Himmel
20/09/2016 10:00,489,314,175,15,4,Klarer Himmel
20/09/2016 11:00,585,339,246,16,6,Klarer Himmel
20/09/2016 12:00,699,343,356,17,7,wolkig
20/09/2016 13:00,776,378,398,18,9,wolkig
20/09/2016 14:00,792,377,415,18,9,wolkig
20/09/2016 15:00,894,434,460,18,6,wolkig
20/09/2016 16:00,1016,484,532,19,0,wolkig
20/09/2016 17:00,1158,543,615,18,2,wolkig
20/09/2016 18:00,1016,451,565,17,0,Klarer Himmel
20/09/2016 19:00,801,366,435,16,0,Klarer Himmel
20/09/2016 20:00,422,205,217,16,4,Klarer Himmel
20/09/2016 21:00,348,183,165,15,6,Klarer Himmel
20/09/2016 22:00,308,167,141,14,4,Klarer Himmel
20/09/2016 23:00,130,63,67,13,4,Klarer Himmel
21/09/2016 00:00,64,26,38,11,2,Klarer Himmel
21/09/2016 01:00,34,13,21,9,0,Klarer Himmel
21/09/2016 02:00,23,8,15,8,0,Klarer Himmel
21/09/2016 03:00,7,3,4,7,0,Klarer Himmel
21/09/2016 04:00,17,7,10,7,0,Nebel
21/09/2016 05:00,77,32,45,6,0,Nebel
21/09/2016 06:00,369,162,207,6,0,Nebel
21/09/2016 07:00,1058,689,369,6,0,Nebel
21/09/2016 08:00,973,650,323,10,0,Klarer Himmel
21/09/2016 09:00,672,464,208,14,2,Klarer Himmel
21/09/2016 10:00,637,410,227,17,4,wolkig
21/09/2016 11:00,696,394,302,18,7,wolkig
21/09/2016 12:00,838,412,426,19,9,Klarer Himmel
21/09/2016 13:00,837,398,439,19,7,Klarer Himmel
21/09/2016 14:00,813,393,420,20,7,Klarer Himmel
21/09/2016 15:00,936,456,480,21,7,Klarer Himmel
21/09/2016 16:00,1015,436,579,20,6,Klarer Himmel
21/09/2016 17:00,1115,531,584,20,6,Klarer Himmel
21/09/2016 18:00,960,421,539,18,4,Klarer Himmel
21/09/2016 19:00,803,357,446,15,6,Klarer Himmel
21/09/2016 20:00,478,243,235,12,0,Klarer Himmel
21/09/2016 21:00,344,187,157,11,4,Klarer Himmel
21/09/2016 22:00,302,161,141,10,0,Klarer Himmel
21/09/2016 23:00,164,73,91,10,4,Klarer Himmel
22/09/2016 00:00,104,43,61,8,0,Klarer Himmel
22/09/2016 01:00,55,25,30,8,0,Klarer Himmel
22/09/2016 02:00,38,24,14,8,0,Klarer Himmel
22/09/2016 03:00,31,16,15,8,4,Klarer Himmel
22/09/2016 04:00,25,13,12,8,2,Klarer Himmel
22/09/2016 05:00,96,35,61,7,2,
22/09/2016 06:00,347,152,195,7,4,Nebel
22/09/2016 07:00,1020,676,344,8,2,Nebel
22/09/2016 08:00,844,564,280,9,2,Klarer Himmel
22/09/2016 09:00,686,479,207,13,6,Klarer Himmel
22/09/2016 10:00,550,334,216,16,7,Klarer Himmel
22/09/2016 11:00,606,358,248,18,9,Klarer Himmel
22/09/2016 12:00,688,322,366,20,13,Klarer Himmel
22/09/2016 13:00,795,378,417,20,9,Klarer Himmel
22/09/2016 14:00,853,405,448,21,11,Klarer Himmel
22/09/2016 15:00,978,466,512,22,9,Klarer Himmel
22/09/2016 16:00,1081,495,586,21,9,Klarer Himmel
22/09/2016 17:00,1166,544,622,20,9,Klarer Himmel
22/09/2016 18:00,1015,465,550,17,2,Klarer Himmel
22/09/2016 19:00,743,372,371,16,0,Klarer Himmel
22/09/2016 20:00,441,185,256,13,0,Klarer Himmel
22/09/2016 21:00,306,160,146,13,0,Klarer Himmel
22/09/2016 22:00,263,121,142,12,0,Klarer Himmel
22/09/2016 23:00,165,91,74,12,0,Klarer Himmel
23/09/2016 00:00,72,40,32,11,0,Klarer Himmel
23/09/2016 01:00,48,19,29,10,0,
23/09/2016 02:00,19,6,13,9,0,Nebel
23/09/2016 03:00,10,2,8,9,0,Nebel
23/09/2016 04:00,20,9,11,9,0,Nebel
23/09/2016 05:00,85,34,51,10,2,Nebel
23/09/2016 06:00,314,140,174,9,2,Nebel
23/09/2016 07:00,954,588,366,9,0,Nebel
23/09/2016 08:00,794,544,250,11,6,Klarer Himmel
23/09/2016 09:00,527,346,181,14,6,Klarer Himmel
23/09/2016 10:00,537,331,206,15,4,Regen
23/09/2016 11:00,644,357,287,16,2,wolkig
23/09/2016 12:00,707,353,354,19,11,teilweise bewölkt
23/09/2016 13:00,888,399,489,21,13,teilweise bewölkt
23/09/2016 14:00,927,462,465,21,17,teilweise bewölkt
23/09/2016 15:00,949,423,526,20,15,teilweise bewölkt
23/09/2016 16:00,872,396,476,21,13,teilweise bewölkt
23/09/2016 17:00,888,406,482,21,19,teilweise bewölkt
23/09/2016 18:00,839,371,468,19,17,teilweise bewölkt
23/09/2016 19:00,686,276,410,16,6,Klarer Himmel
23/09/2016 20:00,461,184,277,13,2,Klarer Himmel
23/09/2016 21:00,334,171,163,11,0,Klarer Himmel
23/09/2016 22:00,317,183,134,10,0,Klarer Himmel
23/09/2016 23:00,269,152,117,9,0,Nebel
24/09/2016 00:00,254,151,103,8,0,Nebel
24/09/2016 01:00,220,148,72,7,0,Nebel
24/09/2016 02:00,131,83,48,7,0,Nebel
24/09/2016 03:00,93,49,44,7,0,Nebel
24/09/2016 04:00,48,29,19,7,4,Nebel
24/09/2016 05:00,72,47,25,7,2,Nebel
24/09/2016 06:00,61,35,26,8,6,Nebel
24/09/2016 07:00,145,80,65,9,4,Klarer Himmel
24/09/2016 08:00,236,146,90,10,6,teilweise bewölkt
24/09/2016 09:00,460,292,168,12,6,teilweise bewölkt
24/09/2016 10:00,640,446,194,15,9,Klarer Himmel
24/09/2016 11:00,767,506,261,18,11,Klarer Himmel
24/09/2016 12:00,837,484,353,21,11,
24/09/2016 13:00,841,426,415,23,15,Klarer Himmel
24/09/2016 14:00,848,373,475,23,15,Klarer Himmel
24/09/2016 15:00,784,362,422,24,9,Klarer Himmel
24/09/2016 16:00,691,292,399,23,9,Klarer Himmel
24/09/2016 17:00,648,256,392,23,7,Klarer Himmel
24/09/2016 18:00,659,258,401,19,4,Klarer Himmel
24/09/2016 19:00,578,239,339,15,2,Klarer Himmel
24/09/2016 20:00,467,208,259,13,0,Klarer Himmel
24/09/2016 21:00,303,140,163,13,4,Klarer Himmel
24/09/2016 22:00,258,158,100,15,7,Klarer Himmel
24/09/2016 23:00,285,183,102,14,6,Klarer Himmel
25/09/2016 00:00,301,182,119,12,6,Klarer Himmel
25/09/2016 01:00,208,125,83,12,4,Klarer Himmel
25/09/2016 02:00,148,90,58,12,4,Klarer Himmel
25/09/2016 03:00,125,73,52,12,6,Klarer Himmel
25/09/2016 04:00,73,52,21,11,7,Klarer Himmel
25/09/2016 05:00,72,54,18,11,7,Klarer Himmel
25/09/2016 06:00,53,35,18,10,4,Klarer Himmel
25/09/2016 07:00,55,23,32,10,7,Klarer Himmel
25/09/2016 08:00,88,34,54,12,7,Klarer Himmel
25/09/2016 09:00,212,130,82,15,13,Klarer Himmel
25/09/2016 10:00,316,183,133,18,15,Klarer Himmel
25/09/2016 11:00,369,221,148,22,11,Klarer Himmel
25/09/2016 12:00,397,195,202,23,13,Klarer Himmel
25/09/2016 13:00,531,278,253,25,17,Klarer Himmel
25/09/2016 14:00,567,287,280,26,11,Klarer Himmel
25/09/2016 15:00,596,311,285,27,13,Klarer Himmel
25/09/2016 16:00,527,270,257,27,20,Klarer Himmel
25/09/2016 17:00,569,290,279,26,13,Klarer Himmel
25/09/2016 18:00,534,290,244,22,6,Klarer Himmel
25/09/2016 19:00,474,270,204,18,0,Klarer Himmel
25/09/2016 20:00,312,173,139,21,24,Klarer Himmel
25/09/2016 21:00,188,118,70,18,20,Klarer Himmel
25/09/2016 22:00,156,95,61,17,11,Klarer Himmel
25/09/2016 23:00,65,36,29,17,9,Klarer Himmel
26/09/2016 00:00,50,30,20,16,11,Klarer Himmel
26/09/2016 01:00,12,6,6,15,7,Klarer Himmel
26/09/2016 02:00,11,6,5,14,6,wolkig
26/09/2016 03:00,4,0,4,14,4,wolkig
26/09/2016 04:00,14,6,8,14,4,wolkig
26/09/2016 05:00,79,38,41,14,6,Klarer Himmel
26/09/2016 06:00,351,165,186,13,6,Klarer Himmel
26/09/2016 07:00,1031,684,347,12,4,Nebel
26/09/2016 08:00,864,564,300,13,0,Klarer Himmel
26/09/2016 09:00,648,427,221,14,6,Klarer Himmel
26/09/2016 10:00,574,364,210,17,4,Klarer Himmel
26/09/2016 11:00,615,344,271,19,7,Klarer Himmel
26/09/2016 12:00,680,362,318,20,2,
26/09/2016 13:00,786,377,409,20,7,teilweise bewölkt
26/09/2016 14:00,758,367,391,21,7,Klarer Himmel
26/09/2016 15:00,882,409,473,21,7,Klarer Himmel
26/09/2016 16:00,1058,465,593,21,6,Klarer Himmel
26/09/2016 17:00,1146,550,596,20,7,Klarer Himmel
26/09/2016 18:00,963,457,506,16,0,Klarer Himmel
26/09/2016 19:00,737,328,409,15,4,Klarer Himmel
26/09/2016 20:00,417,211,206,15,2,Klarer Himmel
26/09/2016 21:00,307,170,137,13,0,Klarer Himmel
26/09/2016 22:00,259,147,112,11,0,Klarer Himmel
26/09/2016 23:00,114,63,51,10,0,Klarer Himmel
27/09/2016 00:00,77,44,33,10,0,Klarer Himmel
27/09/2016 01:00,36,19,17,10,0,Klarer Himmel
27/09/2016 02:00,18,5,13,9,0,Klarer Himmel
27/09/2016 03:00,4,1,3,9,0,Klarer Himmel
27/09/2016 04:00,11,5,6,8,4,Klarer Himmel
27/09/2016 05:00,84,46,38,8,0,Nebel
27/09/2016 06:00,365,161,204,7,0,
27/09/2016 07:00,1053,668,385,7,0,
27/09/2016 08:00,932,616,316,9,0,Klarer Himmel
27/09/2016 09:00,741,529,212,14,0,Klarer Himmel
27/09/2016 10:00,541,332,209,16,7,Klarer Himmel
27/09/2016 11:00,588,333,255,19,6,teilweise bewölkt
27/09/2016 12:00,719,337,382,20,7,teilweise bewölkt
27/09/2016 13:00,745,382,363,21,9,teilweise bewölkt
27/09/2016 14:00,828,420,408,22,11,teilweise bewölkt
27/09/2016 15:00,923,446,477,22,13,Klarer Himmel
27/09/2016 16:00,1086,478,608,22,11,Klarer Himmel
27/09/2016 17:00,1156,570,586,22,13,Klarer Himmel
27/09/2016 18:00,1069,485,584,20,7,Klarer Himmel
27/09/2016 19:00,822,372,450,14,6,Klarer Himmel
27/09/2016 20:00,495,270,225,13,2,Klarer Himmel
27/09/2016 21:00,333,178,155,12,0,Klarer Himmel
27/09/2016 22:00,327,179,148,12,7,Klarer Himmel
27/09/2016 23:00,183,89,94,13,7,Klarer Himmel
28/09/2016 00:00,101,54,47,13,7,Klarer Himmel
28/09/2016 01:00,39,18,21,13,7,Klarer Himmel
28/09/2016 02:00,12,6,6,14,11,wolkig
28/09/2016 03:00,17,2,15,15,13,wolkig
28/09/2016 04:00,17,7,10,15,11,wolkig
28/09/2016 05:00,82,42,40,15,17,teilweise bewölkt
28/09/2016 06:00,350,161,189,15,11,wolkig
28/09/2016 07:00,1009,640,369,16,13,teilweise bewölkt
28/09/2016 08:00,951,634,317,16,19,wolkig
28/09/2016 09:00,626,408,218,17,19,wolkig
28/09/2016 10:00,644,410,234,18,24,wolkig
28/09/2016 11:00,690,381,309,19,26,wolkig
28/09/2016 12:00,747,401,346,20,28,wolkig
28/09/2016 13:00,873,443,430,20,32,wolkig
28/09/2016 14:00,768,337,431,21,24,wolkig
28/09/2016 15:00,891,417,474,21,24,wolkig
28/09/2016 16:00,987,450,537,21,28,Klarer Himmel
28/09/2016 17:00,1158,568,590,22,26,Klarer Himmel
28/09/2016 18:00,985,441,544,21,19,Klarer Himmel
28/09/2016 19:00,795,367,428,20,19,Klarer Himmel
28/09/2016 20:00,428,188,240,20,13,wolkig
28/09/2016 21:00,357,163,194,20,13,wolkig
28/09/2016 22:00,269,149,120,19,15,Klarer Himmel
28/09/2016 23:00,209,101,108,19,17,wolkig
29/09/2016 00:00,114,70,44,19,19,wolkig
29/09/2016 01:00,79,40,39,19,17,wolkig
29/09/2016 02:00,49,24,25,19,22,wolkig
29/09/2016 03:00,36,15,21,19,20,Klarer Himmel
29/09/2016 04:00,26,12,14,18,20,wolkig
29/09/2016 05:00,90,40,50,18,20,wolkig
29/09/2016 06:00,326,138,188,18,20,wolkig
29/09/2016 07:00,1012,639,373,17,20,Klarer Himmel
29/09/2016 08:00,868,560,308,18,22,Klarer Himmel
29/09/2016 09:00,656,454,202,18,20,Klarer Himmel
29/09/2016 10:00,544,342,202,20,26,wolkig
29/09/2016 11:00,610,341,269,20,30,wolkig
29/09/2016 12:00,702,361,341,21,37,wolkig
29/09/2016 13:00,775,351,424,21,33,wolkig
29/09/2016 14:00,763,363,400,20,28,wolkig
29/09/2016 15:00,919,420,499,21,32,wolkig
29/09/2016 16:00,1030,472,558,20,28,wolkig
29/09/2016 17:00,1106,520,586,20,33,wolkig
29/09/2016 18:00,949,455,494,20,30,wolkig
29/09/2016 19:00,714,320,394,19,26,wolkig
29/09/2016 20:00,412,196,216,18,39,Regen
29/09/2016 21:00,285,159,126,16,26,Regen
29/09/2016 22:00,272,145,127,15,19,wolkig
29/09/2016 23:00,143,86,57,15,19,Regen
30/09/2016 00:00,67,36,31,15,15,Regen
30/09/2016 01:00,43,20,23,15,13,wolkig
30/09/2016 02:00,26,7,19,14,13,wolkig
30/09/2016 03:00,8,1,7,14,7,wolkig
30/09/2016 04:00,14,6,8,14,9,wolkig
30/09/2016 05:00,69,32,37,14,9,wolkig
30/09/2016 06:00,287,119,168,14,9,wolkig
30/09/2016 07:00,883,597,286,13,7,
30/09/2016 08:00,691,459,232,14,9,wolkig
30/09/2016 09:00,559,380,179,15,15,wolkig
30/09/2016 10:00,555,337,218,15,15,wolkig
30/09/2016 11:00,651,353,298,16,17,wolkig
30/09/2016 12:00,770,409,361,16,20,wolkig
30/09/2016 13:00,936,431,505,17,24,wolkig
30/09/2016 14:00,929,441,488,18,24,wolkig
30/09/2016 15:00,858,388,470,19,24,teilweise bewölkt
30/09/2016 16:00,864,415,449,18,28,Klarer Himmel
30/09/2016 17:00,868,433,435,18,17,Klarer Himmel
30/09/2016 18:00,794,328,466,17,9,Klarer Himmel
30/09/2016 19:00,644,303,341,13,7,Klarer Himmel
30/09/2016 20:00,422,194,228,11,2,Klarer Himmel
30/09/2016 21:00,293,154,139,9,0,Klarer Himmel
30/09/2016 22:00,298,172,126,8,0,Klarer Himmel
30/09/2016 23:00,256,130,126,9,4,Klarer Himmel
01/10/2016 00:00,156,95,61,9,2,Klarer Himmel
01/10/2016 01:00,166,88,78,10,4,Klarer Himmel
01/10/2016 02:00,121,63,58,10,6,Klarer Himmel
01/10/2016 03:00,67,38,29,10,6,Regen
01/10/2016 04:00,53,35,18,10,2,Regen
01/10/2016 05:00,75,49,26,10,4,wolkig
01/10/2016 06:00,63,36,27,11,2,wolkig
01/10/2016 07:00,104,66,38,11,6,wolkig
01/10/2016 08:00,198,122,76,11,6,wolkig
01/10/2016 09:00,423,289,134,12,6,wolkig
01/10/2016 10:00,571,408,163,13,7,Regen
01/10/2016 11:00,651,395,256,14,7,Regen
01/10/2016 12:00,687,387,300,15,11,wolkig
01/10/2016 13:00,714,366,348,16,7,wolkig
01/10/2016 14:00,790,368,422,16,6,wolkig
01/10/2016 15:00,664,277,387,16,6,wolkig
01/10/2016 16:00,649,280,369,16,7,wolkig
01/10/2016 17:00,569,244,325,16,7,wolkig
01/10/2016 18:00,609,234,375,16,7,wolkig
01/10/2016 19:00,442,198,244,13,6,teilweise bewölkt
01/10/2016 20:00,315,132,183,12,7,Klarer Himmel
01/10/2016 21:00,235,116,119,11,4,wolkig
01/10/2016 22:00,171,100,71,11,6,Regen
01/10/2016 23:00,198,107,91,11,7,wolkig
02/10/2016 00:00,195,126,69,11,7,Regen
02/10/2016 01:00,131,78,53,11,7,
02/10/2016 02:00,81,42,39,11,13,
02/10/2016 03:00,64,40,24,11,11,Klarer Himmel
02/10/2016 04:00,51,36,15,10,11,Klarer Himmel
02/10/2016 05:00,48,31,17,10,6,Klarer Himmel
02/10/2016 06:00,33,23,10,9,9,Klarer Himmel
02/10/2016 07:00,52,25,27,9,11,teilweise bewölkt
02/10/2016 08:00,72,39,33,11,11,teilweise bewölkt
02/10/2016 09:00,171,90,81,12,17,teilweise bewölkt
02/10/2016 10:00,248,148,100,13,19,wolkig
02/10/2016 11:00,238,124,114,12,17,Regen
02/10/2016 12:00,274,140,134,12,17,wolkig
02/10/2016 13:00,249,127,122,12,13,wolkig
02/10/2016 14:00,277,147,130,13,19,wolkig
02/10/2016 15:00,308,166,142,14,15,wolkig
02/10/2016 16:00,341,179,162,14,17,wolkig
02/10/2016 17:00,361,192,169,14,17,Regen
02/10/2016 18:00,301,162,139,12,17,Regen
02/10/2016 19:00,293,123,170,12,15,wolkig
02/10/2016 20:00,200,111,89,12,13,Regen
02/10/2016 21:00,172,80,92,12,13,Regen
02/10/2016 22:00,135,86,49,12,13,wolkig
02/10/2016 23:00,123,69,54,13,11,Regen
03/10/2016 00:00,131,70,61,12,13,wolkig
03/10/2016 01:00,87,52,35,11,17,wolkig
03/10/2016 02:00,61,33,28,9,9,teilweise bewölkt
03/10/2016 03:00,30,14,16,9,6,wolkig
03/10/2016 04:00,29,18,11,10,6,wolkig
03/10/2016 05:00,45,31,14,10,4,wolkig
03/10/2016 06:00,38,27,11,10,9,wolkig
03/10/2016 07:00,101,78,23,10,0,Nebel
03/10/2016 08:00,95,47,48,11,2,wolkig
03/10/2016 09:00,202,133,69,11,4,wolkig
03/10/2016 10:00,260,140,120,12,9,wolkig
03/10/2016 11:00,347,177,170,13,9,wolkig
03/10/2016 12:00,434,241,193,15,9,teilweise bewölkt
03/10/2016 13:00,466,292,174,16,11,teilweise bewölkt
03/10/2016 14:00,534,272,262,16,7,wolkig
03/10/2016 15:00,541,290,251,14,2,Regen
03/10/2016 16:00,466,189,277,13,7,Regen
03/10/2016 17:00,444,171,273,13,4,wolkig
03/10/2016 18:00,359,171,188,13,2,Regen
03/10/2016 19:00,269,135,134,12,2,Nebel
03/10/2016 20:00,225,139,86,10,6,Nebel
03/10/2016 21:00,152,100,52,9,4,Nebel
03/10/2016 22:00,126,81,45,9,0,Nebel
03/10/2016 23:00,76,45,31,10,0,Nebel
04/10/2016 00:00,37,21,16,11,9,wolkig
04/10/2016 01:00,20,10,10,10,2,wolkig
04/10/2016 02:00,10,5,5,11,17,wolkig
04/10/2016 03:00,5,2,3,11,17,wolkig
04/10/2016 04:00,16,7,9,11,11,wolkig
04/10/2016 05:00,78,36,42,12,15,wolkig
04/10/2016 06:00,330,146,184,11,9,wolkig
04/10/2016 07:00,1001,628,373,11,4,teilweise bewölkt
04/10/2016 08:00,854,592,262,11,6,teilweise bewölkt
04/10/2016 09:00,707,490,217,12,17,wolkig
04/10/2016 10:00,566,358,208,12,11,wolkig
04/10/2016 11:00,649,372,277,14,9,wolkig
04/10/2016 12:00,650,332,318,15,17,teilweise bewölkt
04/10/2016 13:00,764,385,379,15,13,teilweise bewölkt
04/10/2016 14:00,757,385,372,16,15,teilweise bewölkt
04/10/2016 15:00,899,425,474,17,15,teilweise bewölkt
04/10/2016 16:00,1108,515,593,16,15,teilweise bewölkt
04/10/2016 17:00,1196,543,653,15,11,teilweise bewölkt
04/10/2016 18:00,1012,444,568,14,7,teilweise bewölkt
04/10/2016 19:00,786,342,444,12,7,teilweise bewölkt
04/10/2016 20:00,409,207,202,9,0,Klarer Himmel
04/10/2016 21:00,312,148,164,9,6,Klarer Himmel
04/10/2016 22:00,284,163,121,10,13,Klarer Himmel
04/10/2016 23:00,144,79,65,10,11,Klarer Himmel
05/10/2016 00:00,70,25,45,10,7,Klarer Himmel
05/10/2016 01:00,42,18,24,9,11,Klarer Himmel
05/10/2016 02:00,24,10,14,8,11,Klarer Himmel
05/10/2016 03:00,10,6,4,8,7,Klarer Himmel
05/10/2016 04:00,16,7,9,7,11,Klarer Himmel
05/10/2016 05:00,82,30,52,7,9,Klarer Himmel
05/10/2016 06:00,340,155,185,6,9,Klarer Himmel
05/10/2016 07:00,956,621,335,5,6,Klarer Himmel
05/10/2016 08:00,920,634,286,7,15,Klarer Himmel
05/10/2016 09:00,709,503,206,8,13,Klarer Himmel
05/10/2016 10:00,626,412,214,9,17,teilweise bewölkt
05/10/2016 11:00,742,417,325,,,
05/10/2016 12:00,753,388,365,12,11,teilweise bewölkt
05/10/2016 13:00,882,430,452,13,17,teilweise bewölkt
05/10/2016 14:00,836,383,453,13,24,
05/10/2016 15:00,838,382,456,12,15,Klarer Himmel
05/10/2016 16:00,1074,433,641,13,17,Klarer Himmel
05/10/2016 17:00,1130,535,595,12,20,Klarer Himmel
05/10/2016 18:00,983,456,527,10,11,Klarer Himmel
05/10/2016 19:00,788,363,425,8,9,Klarer Himmel
05/10/2016 20:00,441,215,226,7,9,Klarer Himmel
05/10/2016 21:00,390,182,208,8,13,Klarer Himmel
05/10/2016 22:00,278,144,134,6,7,Klarer Himmel
05/10/2016 23:00,154,77,77,6,11,Klarer Himmel
06/10/2016 00:00,96,41,55,5,2,teilweise bewölkt
06/10/2016 01:00,68,27,41,4,7,Klarer Himmel
06/10/2016 02:00,40,8,32,6,15,Klarer Himmel
06/10/2016 03:00,27,9,18,6,13,wolkig
06/10/2016 04:00,24,12,12,7,9,wolkig
06/10/2016 05:00,100,41,59,7,11,wolkig
06/10/2016 06:00,312,132,180,8,13,wolkig
06/10/2016 07:00,952,615,337,8,13,wolkig
06/10/2016 08:00,864,572,292,8,13,wolkig
06/10/2016 09:00,640,460,180,8,19,wolkig
06/10/2016 10:00,517,337,180,9,19,wolkig
06/10/2016 11:00,556,308,248,9,13,Regen
06/10/2016 12:00,586,276,310,10,15,wolkig
06/10/2016 13:00,756,370,386,11,17,wolkig
06/10/2016 14:00,757,355,402,11,17,wolkig
06/10/2016 15:00,880,395,485,11,17,wolkig
06/10/2016 16:00,1011,442,569,11,19,wolkig
06/10/2016 17:00,1082,469,613,11,22,wolkig
06/10/2016 18:00,974,417,557,10,15,wolkig
06/10/2016 19:00,730,321,409,10,19,wolkig
06/10/2016 20:00,376,169,207,11,19,wolkig
06/10/2016 21:00,296,162,134,10,19,wolkig
06/10/2016 22:00,229,114,115,10,15,wolkig
06/10/2016 23:00,192,120,72,10,17,wolkig
07/10/2016 00:00,145,105,40,10,19,wolkig
07/10/2016 01:00,60,33,27,10,20,wolkig
07/10/2016 02:00,23,13,10,10,22,wolkig
07/10/2016 03:00,20,9,11,10,17,wolkig
07/10/2016 04:00,23,8,15,10,19,wolkig
07/10/2016 05:00,84,36,48,10,11,wolkig
07/10/2016 06:00,281,118,163,10,15,wolkig
07/10/2016 07:00,886,593,293,10,15,wolkig
07/10/2016 08:00,733,482,251,10,11,wolkig
07/10/2016 09:00,618,432,186,11,15,wolkig
07/10/2016 10:00,549,327,222,11,13,wolkig
07/10/2016 11:00,602,313,289,12,9,wolkig
07/10/2016 12:00,729,365,364,13,11,wolkig
07/10/2016 13:00,872,398,474,14,15,teilweise bewölkt
07/10/2016 14:00,950,452,498,13,15,teilweise bewölkt
07/10/2016 15:00,852,416,436,13,17,wolkig
07/10/2016 16:00,856,378,478,14,15,wolkig
07/10/2016 17:00,859,412,447,13,19,wolkig
07/10/2016 18:00,759,329,430,12,17,wolkig
07/10/2016 19:00,610,227,383,12,11,wolkig
07/10/2016 20:00,414,186,228,12,17,wolkig
07/10/2016 21:00,308,175,133,11,11,Regen
07/10/2016 22:00,225,134,91,11,13,wolkig
07/10/2016 23:00,204,98,106,11,15,Regen
08/10/2016 00:00,216,113,103,10,11,wolkig
08/10/2016 01:00,198,70,128,10,11,wolkig
08/10/2016 02:00,101,55,46,10,11,wolkig
08/10/2016 03:00,63,34,29,8,7,Klarer Himmel
08/10/2016 04:00,45,23,22,7,4,Klarer Himmel
08/10/2016 05:00,64,43,21,6,2,Nebel
08/10/2016 06:00,70,50,20,5,4,Nebel
08/10/2016 07:00,123,74,49,6,0,Nebel
08/10/2016 08:00,211,145,66,8,6,teilweise bewölkt
08/10/2016 09:00,419,301,118,10,13,Klarer Himmel
08/10/2016 10:00,594,418,176,11,15,teilweise bewölkt
08/10/2016 11:00,775,491,284,12,13,teilweise bewölkt
08/10/2016 12:00,788,455,333,12,15,teilweise bewölkt
08/10/2016 13:00,841,403,438,12,22,teilweise bewölkt
08/10/2016 14:00,773,330,443,13,9,teilweise bewölkt
08/10/2016 15:00,687,307,380,13,11,teilweise bewölkt
08/10/2016 16:00,559,212,347,13,11,teilweise bewölkt
08/10/2016 17:00,590,227,363,12,15,teilweise bewölkt
08/10/2016 18:00,568,218,350,10,7,wolkig
08/10/2016 19:00,531,223,308,8,4,wolkig
08/10/2016 20:00,313,155,158,8,0,Klarer Himmel
08/10/2016 21:00,236,119,117,8,0,wolkig
08/10/2016 22:00,221,131,90,8,4,wolkig
08/10/2016 23:00,244,116,128,8,4,wolkig
09/10/2016 00:00,204,128,76,8,4,wolkig
09/10/2016 01:00,173,88,85,7,4,wolkig
09/10/2016 02:00,143,79,64,6,6,Klarer Himmel
09/10/2016 03:00,101,52,49,6,0,Klarer Himmel
09/10/2016 04:00,76,48,28,5,2,Nebel
09/10/2016 05:00,46,27,19,4,0,Nebel
09/10/2016 06:00,37,24,13,3,4,Nebel
09/10/2016 07:00,39,18,21,2,0,Nebel
09/10/2016 08:00,68,33,35,4,0,Nebel
09/10/2016 09:00,145,74,71,6,4,Klarer Himmel
09/10/2016 10:00,253,165,88,8,6,Klarer Himmel
09/10/2016 11:00,251,129,122,11,7,teilweise bewölkt
09/10/2016 12:00,353,198,155,11,13,wolkig
09/10/2016 13:00,373,218,155,11,9,wolkig
09/10/2016 14:00,396,205,191,12,9,wolkig
09/10/2016 15:00,418,210,208,12,11,wolkig
09/10/2016 16:00,430,198,232,11,9,wolkig
09/10/2016 17:00,466,211,255,11,7,wolkig
09/10/2016 18:00,405,196,209,10,6,Regen
09/10/2016 19:00,339,184,155,8,0,wolkig
09/10/2016 20:00,253,146,107,9,0,wolkig
09/10/2016 21:00,146,85,61,8,0,wolkig
09/10/2016 22:00,173,106,67,8,0,wolkig
09/10/2016 23:00,79,35,44,7,0,wolkig
10/10/2016 00:00,39,25,14,8,4,wolkig
10/10/2016 01:00,17,7,10,7,4,wolkig
10/10/2016 02:00,5,3,2,5,4,teilweise bewölkt
10/10/2016 03:00,3,1,2,7,7,wolkig
10/10/2016 04:00,11,7,4,7,0,wolkig
10/10/2016 05:00,80,37,43,6,7,wolkig
10/10/2016 06:00,288,131,157,6,6,Nebel
10/10/2016 07:00,591,378,213,6,4,Nebel
10/10/2016 08:00,710,482,228,6,6,Nebel
10/10/2016 09:00,681,477,204,6,4,Nebel
10/10/2016 10:00,521,315,206,8,4,teilweise bewölkt
10/10/2016 11:00,563,347,216,10,4,teilweise bewölkt
10/10/2016 12:00,589,321,268,10,11,teilweise bewölkt
10/10/2016 13:00,664,336,328,10,11,wolkig
10/10/2016 14:00,651,328,323,11,9,wolkig
10/10/2016 15:00,739,368,371,11,11,wolkig
10/10/2016 16:00,952,419,533,11,9,wolkig
10/10/2016 17:00,1034,465,569,10,9,wolkig
10/10/2016 18:00,855,356,499,8,6,teilweise bewölkt
10/10/2016 19:00,661,300,361,6,0,teilweise bewölkt
10/10/2016 20:00,406,197,209,6,0,wolkig
10/10/2016 21:00,261,127,134,5,0,Nebel
10/10/2016 22:00,222,97,125,4,2,Nebel
10/10/2016 23:00,167,65,102,2,0,Nebel
11/10/2016 00:00,115,41,74,2,0,Nebel
11/10/2016 01:00,43,18,25,1,0,Nebel
11/10/2016 02:00,52,35,17,0,0,Nebel
11/10/2016 03:00,31,22,9,1,4,Nebel
11/10/2016 04:00,26,13,13,1,4,Nebel
11/10/2016 05:00,70,32,38,3,6,Nebel
11/10/2016 06:00,277,142,135,4,4,wolkig
11/10/2016 07:00,622,409,213,4,0,wolkig
11/10/2016 08:00,734,517,217,5,0,wolkig
11/10/2016 09:00,553,374,179,6,2,Regen
11/10/2016 10:00,453,298,155,7,4,Regen
11/10/2016 11:00,482,271,211,8,0,Regen
11/10/2016 12:00,500,246,254,9,2,wolkig
11/10/2016 13:00,575,307,268,9,2,wolkig
11/10/2016 14:00,544,269,275,10,2,wolkig
11/10/2016 15:00,704,339,365,10,6,wolkig
11/10/2016 16:00,872,372,500,10,6,wolkig
11/10/2016 17:00,941,412,529,10,6,wolkig
11/10/2016 18:00,841,359,482,10,6,wolkig
11/10/2016 19:00,669,251,418,9,6,wolkig
11/10/2016 20:00,439,206,233,9,6,Regen
11/10/2016 21:00,293,152,141,9,7,Regen
11/10/2016 22:00,291,167,124,9,11,Regen
11/10/2016 23:00,223,70,153,9,13,wolkig
12/10/2016 00:00,107,50,57,9,13,wolkig
12/10/2016 01:00,69,38,31,8,15,wolkig
12/10/2016 02:00,58,37,21,8,13,wolkig
12/10/2016 03:00,42,33,9,8,11,wolkig
12/10/2016 04:00,43,27,16,8,11,Regen
12/10/2016 05:00,74,33,41,8,9,wolkig
12/10/2016 06:00,269,130,139,7,13,wolkig
12/10/2016 07:00,587,369,218,7,13,wolkig
12/10/2016 08:00,773,553,220,7,9,wolkig
12/10/2016 09:00,600,445,155,8,13,wolkig
12/10/2016 10:00,535,349,186,8,9,wolkig
12/10/2016 11:00,591,368,223,8,11,Regen
12/10/2016 12:00,639,329,310,8,13,wolkig
12/10/2016 13:00,613,301,312,8,7,wolkig
12/10/2016 14:00,663,312,351,9,11,wolkig
12/10/2016 15:00,674,289,385,9,11,wolkig
12/10/2016 16:00,856,368,488,9,7,wolkig
12/10/2016 17:00,931,409,522,8,11,Regen
12/10/2016 18:00,819,373,446,8,9,wolkig
12/10/2016 19:00,680,301,379,7,6,wolkig
12/10/2016 20:00,430,215,215,7,9,wolkig
12/10/2016 21:00,364,181,183,7,6,wolkig
12/10/2016 22:00,268,153,115,8,6,wolkig
12/10/2016 23:00,172,78,94,8,11,wolkig
13/10/2016 00:00,121,50,71,8,11,wolkig
13/10/2016 01:00,102,37,65,8,7,wolkig
13/10/2016 02:00,67,11,56,8,9,wolkig
13/10/2016 03:00,78,28,50,8,9,wolkig
13/10/2016 04:00,40,12,28,8,7,wolkig
13/10/2016 05:00,87,38,49,8,9,wolkig
13/10/2016 06:00,263,127,136,8,7,wolkig
13/10/2016 07:00,584,364,220,8,11,wolkig
13/10/2016 08:00,642,455,187,8,7,wolkig
13/10/2016 09:00,542,387,155,8,9,wolkig
13/10/2016 10:00,408,267,141,9,11,wolkig
13/10/2016 11:00,483,280,203,9,11,wolkig
13/10/2016 12:00,593,303,290,9,11,wolkig
13/10/2016 13:00,615,309,306,9,11,wolkig
13/10/2016 14:00,648,311,337,9,13,wolkig
13/10/2016 15:00,719,351,368,10,17,wolkig
13/10/2016 16:00,867,347,520,10,11,wolkig
13/10/2016 17:00,908,374,534,9,15,wolkig
13/10/2016 18:00,828,377,451,9,13,wolkig
13/10/2016 19:00,670,294,376,9,11,wolkig
13/10/2016 20:00,444,228,216,8,13,wolkig
13/10/2016 21:00,302,153,149,8,15,wolkig
13/10/2016 22:00,264,144,120,8,11,wolkig
13/10/2016 23:00,169,72,97,8,13,wolkig
14/10/2016 00:00,124,32,92,8,13,teilweise bewölkt
14/10/2016 01:00,90,41,49,7,11,Klarer Himmel
14/10/2016 02:00,59,33,26,7,11,teilweise bewölkt
14/10/2016 03:00,46,33,13,7,13,teilweise bewölkt
14/10/2016 04:00,43,38,5,7,11,wolkig
14/10/2016 05:00,78,43,35,7,11,Klarer Himmel
14/10/2016 06:00,247,133,114,7,11,Klarer Himmel
14/10/2016 07:00,515,324,191,7,9,Klarer Himmel
14/10/2016 08:00,604,413,191,7,13,Klarer Himmel
14/10/2016 09:00,528,377,151,8,15,Klarer Himmel
14/10/2016 10:00,476,308,168,9,15,wolkig
14/10/2016 11:00,526,295,231,10,15,wolkig
14/10/2016 12:00,650,315,335,12,17,wolkig
14/10/2016 13:00,740,341,399,13,11,Klarer Himmel
14/10/2016 14:00,803,351,452,13,15,Klarer Himmel
14/10/2016 15:00,753,357,396,13,11,Klarer Himmel
14/10/2016 16:00,789,353,436,12,13,Klarer Himmel
14/10/2016 17:00,796,380,416,12,9,Klarer Himmel
14/10/2016 18:00,743,306,437,12,11,Klarer Himmel
14/10/2016 19:00,597,264,333,10,13,Klarer Himmel
14/10/2016 20:00,414,188,226,10,9,Klarer Himmel
14/10/2016 21:00,301,136,165,9,11,Klarer Himmel
14/10/2016 22:00,263,143,120,9,7,Klarer Himmel
14/10/2016 23:00,211,82,129,9,7,Klarer Himmel
15/10/2016 00:00,227,105,122,10,9,Regen
15/10/2016 01:00,171,98,73,10,9,Klarer Himmel
15/10/2016 02:00,90,41,49,10,6,Klarer Himmel
15/10/2016 03:00,93,66,27,10,6,Klarer Himmel
15/10/2016 04:00,62,39,23,9,6,Klarer Himmel
15/10/2016 05:00,74,48,26,9,9,Klarer Himmel
15/10/2016 06:00,59,28,31,8,4,Klarer Himmel
15/10/2016 07:00,113,55,58,8,7,teilweise bewölkt
15/10/2016 08:00,198,120,78,9,7,wolkig
15/10/2016 09:00,320,205,115,10,11,Regen
15/10/2016 10:00,461,301,160,11,9,wolkig
15/10/2016 11:00,486,285,201,11,9,
15/10/2016 12:00,671,370,301,12,7,wolkig
15/10/2016 13:00,611,307,304,13,17,Regen
15/10/2016 14:00,548,252,296,13,13,wolkig
15/10/2016 15:00,516,218,298,13,11,Regen
15/10/2016 16:00,472,185,287,13,9,Regen
15/10/2016 17:00,467,202,265,13,6,wolkig
15/10/2016 18:00,484,202,282,12,6,wolkig
15/10/2016 19:00,415,198,217,11,7,Nebel
15/10/2016 20:00,329,171,158,8,0,Nebel
15/10/2016 21:00,248,145,103,7,4,Nebel
15/10/2016 22:00,229,101,128,7,0,Nebel
15/10/2016 23:00,178,85,93,7,2,Nebel
16/10/2016 00:00,194,96,98,5,6,Nebel
16/10/2016 01:00,197,96,101,4,0,Nebel
16/10/2016 02:00,108,47,61,5,0,Nebel
16/10/2016 03:00,89,61,28,5,0,Nebel
16/10/2016 04:00,56,34,22,6,4,Nebel
16/10/2016 05:00,54,39,15,6,4,Nebel
16/10/2016 06:00,54,38,16,6,4,Nebel
16/10/2016 07:00,50,15,35,5,4,Nebel
16/10/2016 08:00,73,31,42,6,4,Nebel
16/10/2016 09:00,126,70,56,8,4,Klarer Himmel
16/10/2016 10:00,209,124,85,10,6,Klarer Himmel
16/10/2016 11:00,300,144,156,12,7,Klarer Himmel
16/10/2016 12:00,358,208,150,15,7,Klarer Himmel
16/10/2016 13:00,425,239,186,17,7,Klarer Himmel
16/10/2016 14:00,546,298,248,18,9,Klarer Himmel
16/10/2016 15:00,507,259,248,18,6,Klarer Himmel
16/10/2016 16:00,571,278,293,17,6,Klarer Himmel
16/10/2016 17:00,569,254,315,16,4,Klarer Himmel
16/10/2016 18:00,559,281,278,13,6,Klarer Himmel
16/10/2016 19:00,363,207,156,13,6,Klarer Himmel
16/10/2016 20:00,285,188,97,13,6,Klarer Himmel
16/10/2016 21:00,175,109,66,12,7,Klarer Himmel
16/10/2016 22:00,182,121,61,12,7,Klarer Himmel
16/10/2016 23:00,74,41,33,11,11,Klarer Himmel
17/10/2016 00:00,63,38,25,11,7,Klarer Himmel
17/10/2016 01:00,26,15,11,11,7,Klarer Himmel
17/10/2016 02:00,7,6,1,11,7,Klarer Himmel
17/10/2016 03:00,4,3,1,10,6,Klarer Himmel
17/10/2016 04:00,9,4,5,10,2,Klarer Himmel
17/10/2016 05:00,77,32,45,10,6,Klarer Himmel
17/10/2016 06:00,288,138,150,10,6,Klarer Himmel
17/10/2016 07:00,700,474,226,10,6,Klarer Himmel
17/10/2016 08:00,757,531,226,10,2,Klarer Himmel
17/10/2016 09:00,740,557,183,11,7,Klarer Himmel
17/10/2016 10:00,598,357,241,13,7,wolkig
17/10/2016 11:00,658,396,262,15,7,Klarer Himmel
17/10/2016 12:00,703,376,327,15,9,wolkig
17/10/2016 13:00,733,394,339,16,7,wolkig
17/10/2016 14:00,674,311,363,15,13,wolkig
17/10/2016 15:00,814,370,444,15,7,wolkig
17/10/2016 16:00,1047,421,626,15,7,wolkig
17/10/2016 17:00,1162,520,642,14,6,Klarer Himmel
17/10/2016 18:00,1017,412,605,13,6,Klarer Himmel
17/10/2016 19:00,691,284,407,12,6,Klarer Himmel
17/10/2016 20:00,392,187,205,10,0,Nebel
17/10/2016 21:00,244,120,124,10,4,Nebel
17/10/2016 22:00,239,133,106,9,2,Nebel
17/10/2016 23:00,151,71,80,7,7,Nebel
18/10/2016 00:00,80,38,42,9,4,Nebel
18/10/2016 01:00,20,9,11,10,6,Nebel
18/10/2016 02:00,15,8,7,9,4,Nebel
18/10/2016 03:00,5,1,4,7,4,Nebel
18/10/2016 04:00,13,6,7,7,4,Nebel
18/10/2016 05:00,91,31,60,7,4,Nebel
18/10/2016 06:00,294,141,153,8,6,Nebel
18/10/2016 07:00,770,549,221,8,7,Nebel
18/10/2016 08:00,824,581,243,8,6,Nebel
18/10/2016 09:00,718,529,189,10,13,wolkig
18/10/2016 10:00,580,365,215,11,15,wolkig
18/10/2016 11:00,665,374,291,12,15,wolkig
18/10/2016 12:00,678,318,360,14,17,wolkig
18/10/2016 13:00,715,366,349,15,20,wolkig
18/10/2016 14:00,717,310,407,15,19,wolkig
18/10/2016 15:00,831,366,465,14,13,Regen
18/10/2016 16:00,957,392,565,13,15,Regen
18/10/2016 17:00,1033,434,599,13,17,Regen
18/10/2016 18:00,958,404,554,12,17,Regen
18/10/2016 19:00,576,255,321,11,15,Regen
18/10/2016 20:00,365,171,194,9,4,Regen
18/10/2016 21:00,252,125,127,10,11,wolkig
18/10/2016 22:00,258,127,131,10,11,Klarer Himmel
18/10/2016 23:00,139,61,78,9,13,
19/10/2016 00:00,88,32,56,8,9,teilweise bewölkt
19/10/2016 01:00,50,22,28,8,11,wolkig
19/10/2016 02:00,35,30,5,9,15,Regen
19/10/2016 03:00,38,30,8,8,17,wolkig
19/10/2016 04:00,41,33,8,7,17,wolkig
19/10/2016 05:00,82,36,46,8,17,wolkig
19/10/2016 06:00,264,112,152,7,13,Regen
19/10/2016 07:00,727,524,203,7,15,Regen
19/10/2016 08:00,713,508,205,8,15,Regen
19/10/2016 09:00,548,388,160,8,11,Regen
19/10/2016 10:00,362,203,159,7,15,Regen
19/10/2016 11:00,338,190,148,7,11,Regen
19/10/2016 12:00,352,150,202,7,13,Regen
19/10/2016 13:00,483,231,252,7,17,Regen
19/10/2016 14:00,456,190,266,7,19,Regen
19/10/2016 15:00,517,218,299,7,20,Regen
19/10/2016 16:00,598,233,365,8,15,wolkig
19/10/2016 17:00,784,348,436,7,9,wolkig
19/10/2016 18:00,726,330,396,8,7,wolkig
19/10/2016 19:00,579,284,295,7,11,wolkig
19/10/2016 20:00,383,204,179,7,9,Regen
19/10/2016 21:00,237,118,119,8,4,Regen
19/10/2016 22:00,223,130,93,7,11,Regen
19/10/2016 23:00,182,67,115,7,7,wolkig
20/10/2016 00:00,114,40,74,6,4,wolkig
20/10/2016 01:00,93,15,78,5,2,Nebel
20/10/2016 02:00,64,25,39,5,0,Nebel
20/10/2016 03:00,67,25,42,4,2,Nebel
20/10/2016 04:00,54,30,24,2,0,Nebel
20/10/2016 05:00,84,35,49,3,0,Nebel
20/10/2016 06:00,256,110,146,4,4,Nebel
20/10/2016 07:00,659,481,178,4,0,Nebel
20/10/2016 08:00,724,508,216,4,6,Nebel
20/10/2016 09:00,593,429,164,6,0,Nebel
20/10/2016 10:00,537,324,213,7,2,wolkig
20/10/2016 11:00,585,356,229,8,4,wolkig
20/10/2016 12:00,597,298,299,9,6,wolkig
20/10/2016 13:00,669,320,349,9,6,wolkig
20/10/2016 14:00,631,273,358,9,7,wolkig
20/10/2016 15:00,794,363,431,9,7,wolkig
20/10/2016 16:00,968,390,578,9,7,wolkig
20/10/2016 17:00,1039,472,567,8,4,wolkig
20/10/2016 18:00,837,365,472,8,9,Regen
20/10/2016 19:00,635,281,354,8,6,wolkig
20/10/2016 20:00,395,165,230,8,6,wolkig
20/10/2016 21:00,281,147,134,7,6,wolkig
20/10/2016 22:00,240,122,118,7,7,wolkig
20/10/2016 23:00,141,60,81,7,7,wolkig
21/10/2016 00:00,118,65,53,7,4,wolkig
21/10/2016 01:00,60,29,31,7,11,wolkig
21/10/2016 02:00,37,13,24,7,11,wolkig
21/10/2016 03:00,23,14,9,5,6,Nebel
21/10/2016 04:00,16,7,9,6,9,wolkig
21/10/2016 05:00,74,26,48,6,9,wolkig
21/10/2016 06:00,239,111,128,6,6,wolkig
21/10/2016 07:00,557,385,172,6,13,wolkig
21/10/2016 08:00,649,454,195,6,9,wolkig
21/10/2016 09:00,582,422,160,6,11,wolkig
21/10/2016 10:00,560,332,228,7,9,wolkig
21/10/2016 11:00,634,333,301,7,13,wolkig
21/10/2016 12:00,648,318,330,8,11,wolkig
21/10/2016 13:00,714,325,389,9,19,wolkig
21/10/2016 14:00,739,307,432,8,22,Regen
21/10/2016 15:00,754,350,404,8,17,Regen
21/10/2016 16:00,629,266,363,8,13,Regen
21/10/2016 17:00,570,230,340,8,11,Regen
21/10/2016 18:00,452,177,275,8,11,Regen
21/10/2016 19:00,432,202,230,8,9,Regen
21/10/2016 20:00,314,152,162,8,7,Regen
21/10/2016 21:00,226,112,114,8,6,wolkig
21/10/2016 22:00,193,105,88,8,4,wolkig
21/10/2016 23:00,176,88,88,8,4,wolkig
22/10/2016 00:00,164,59,105,8,6,wolkig
22/10/2016 01:00,127,49,78,8,6,wolkig
22/10/2016 02:00,87,45,42,8,7,wolkig
22/10/2016 03:00,54,24,30,7,7,wolkig
22/10/2016 04:00,60,33,27,7,7,wolkig
22/10/2016 05:00,58,34,24,7,7,wolkig
22/10/2016 06:00,55,31,24,7,7,wolkig
22/10/2016 07:00,108,75,33,7,9,wolkig
22/10/2016 08:00,183,110,73,7,11,wolkig
22/10/2016 09:00,355,247,108,7,11,wolkig
22/10/2016 10:00,489,298,191,7,9,wolkig
22/10/2016 11:00,617,372,245,8,11,wolkig
22/10/2016 12:00,678,382,296,8,7,wolkig
22/10/2016 13:00,673,351,322,8,11,wolkig
22/10/2016 14:00,670,288,382,8,9,wolkig
22/10/2016 15:00,652,296,356,8,9,Regen
22/10/2016 16:00,583,244,339,8,6,wolkig
22/10/2016 17:00,519,230,289,8,4,wolkig
22/10/2016 18:00,557,239,318,7,4,Nebel
22/10/2016 19:00,451,218,233,7,0,
22/10/2016 20:00,346,153,193,6,0,Nebel
22/10/2016 21:00,267,133,134,5,2,Nebel
22/10/2016 22:00,274,137,137,4,4,Nebel
22/10/2016 23:00,197,81,116,2,0,Nebel
23/10/2016 00:00,225,103,122,2,2,Nebel
23/10/2016 01:00,191,86,105,1,0,Nebel
23/10/2016 02:00,104,54,50,1,4,Nebel
23/10/2016 03:00,104,50,54,1,2,Nebel
23/10/2016 04:00,73,45,28,1,4,Nebel
23/10/2016 05:00,52,33,19,1,2,Nebel
23/10/2016 06:00,38,29,9,1,2,Nebel
23/10/2016 07:00,47,25,22,1,4,Nebel
23/10/2016 08:00,77,28,49,2,4,Nebel
23/10/2016 09:00,116,53,63,2,6,Nebel
23/10/2016 10:00,187,94,93,3,4,Nebel
23/10/2016 11:00,225,116,109,4,6,Nebel
23/10/2016 12:00,275,140,135,6,6,wolkig
23/10/2016 13:00,347,183,164,7,6,teilweise bewölkt
23/10/2016 14:00,409,232,177,9,6,teilweise bewölkt
23/10/2016 15:00,469,277,192,10,7,teilweise bewölkt
23/10/2016 16:00,429,236,193,11,4,teilweise bewölkt
23/10/2016 17:00,547,270,277,9,4,teilweise bewölkt
23/10/2016 18:00,419,210,209,6,4,Nebel
23/10/2016 19:00,316,146,170,5,6,Nebel
23/10/2016 20:00,259,157,102,5,6,Nebel
23/10/2016 21:00,172,117,55,5,4,Nebel
23/10/2016 22:00,162,91,71,4,6,Nebel
23/10/2016 23:00,68,47,21,5,4,Nebel
24/10/2016 00:00,30,22,8,5,6,Nebel
24/10/2016 01:00,10,1,9,4,6,Nebel
24/10/2016 02:00,4,2,2,4,7,Nebel
24/10/2016 03:00,5,3,2,4,6,Nebel
24/10/2016 04:00,10,5,5,4,6,Nebel
24/10/2016 05:00,76,29,47,5,7,
24/10/2016 06:00,338,153,185,5,7,
24/10/2016 07:00,992,684,308,5,9,
24/10/2016 08:00,906,608,298,5,6,
24/10/2016 09:00,725,535,190,6,9,
24/10/2016 10:00,549,356,193,7,11,Klarer Himmel
24/10/2016 11:00,619,390,229,8,9,Klarer Himmel
24/10/2016 12:00,683,310,373,8,9,Klarer Himmel
24/10/2016 13:00,795,396,399,9,6,Klarer Himmel
24/10/2016 14:00,763,375,388,9,7,Regen
24/10/2016 15:00,699,289,410,8,7,Regen
24/10/2016 16:00,808,313,495,8,9,Regen
24/10/2016 17:00,832,377,455,8,7,Regen
24/10/2016 18:00,815,348,467,8,6,Regen
24/10/2016 19:00,572,222,350,8,6,Regen
24/10/2016 20:00,325,139,186,8,4,Regen
24/10/2016 21:00,263,117,146,8,6,Regen
24/10/2016 22:00,171,86,85,8,4,wolkig
24/10/2016 23:00,91,51,40,8,7,wolkig
25/10/2016 00:00,64,27,37,8,6,wolkig
25/10/2016 01:00,30,6,24,8,6,Regen
25/10/2016 02:00,16,2,14,8,2,Regen
25/10/2016 03:00,12,2,10,8,6,Regen
25/10/2016 04:00,14,8,6,8,4,Regen
25/10/2016 05:00,81,35,46,8,4,Regen
25/10/2016 06:00,312,127,185,8,6,Regen
25/10/2016 07:00,1040,716,324,8,4,wolkig
25/10/2016 08:00,923,639,284,8,7,wolkig
25/10/2016 09:00,736,538,198,8,7,wolkig
25/10/2016 10:00,486,294,192,8,7,wolkig
25/10/2016 11:00,511,279,232,8,9,wolkig
25/10/2016 12:00,656,325,331,9,7,wolkig
25/10/2016 13:00,724,348,376,9,7,wolkig
25/10/2016 14:00,727,324,403,9,6,wolkig
25/10/2016 15:00,878,415,463,9,4,wolkig
25/10/2016 16:00,1022,426,596,9,4,wolkig
25/10/2016 17:00,1174,525,649,9,6,wolkig
25/10/2016 18:00,962,393,569,7,0,Nebel
25/10/2016 19:00,827,337,490,6,0,Nebel
25/10/2016 20:00,462,209,253,7,2,Nebel
25/10/2016 21:00,369,184,185,4,0,Nebel
25/10/2016 22:00,354,170,184,5,4,Nebel
25/10/2016 23:00,183,98,85,4,4,Nebel
26/10/2016 00:00,68,40,28,2,2,Nebel
26/10/2016 01:00,34,13,21,2,0,Nebel
26/10/2016 02:00,21,4,17,2,0,Nebel
26/10/2016 03:00,21,9,12,3,2,wolkig
26/10/2016 04:00,11,4,7,4,0,wolkig
26/10/2016 05:00,87,41,46,5,0,wolkig
26/10/2016 06:00,356,152,204,5,0,wolkig
26/10/2016 07:00,1067,739,328,5,0,wolkig
26/10/2016 08:00,974,691,283,6,0,wolkig
26/10/2016 09:00,818,597,221,7,6,wolkig
26/10/2016 10:00,630,386,244,8,2,wolkig
26/10/2016 11:00,704,423,281,9,0,wolkig
26/10/2016 12:00,800,377,423,10,6,wolkig
26/10/2016 13:00,904,447,457,10,4,wolkig
26/10/2016 14:00,862,400,462,10,4,wolkig
26/10/2016 15:00,902,422,480,11,4,wolkig
26/10/2016 16:00,1051,432,619,11,6,wolkig
26/10/2016 17:00,1148,563,585,10,6,
26/10/2016 18:00,1051,440,611,8,6,Nebel
26/10/2016 19:00,827,352,475,8,6,wolkig
26/10/2016 20:00,509,244,265,8,7,wolkig
26/10/2016 21:00,363,150,213,8,6,wolkig
26/10/2016 22:00,393,197,196,8,7,wolkig
26/10/2016 23:00,220,85,135,9,9,wolkig
27/10/2016 00:00,108,44,64,9,7,
27/10/2016 01:00,76,39,37,9,6,wolkig
27/10/2016 02:00,54,25,29,9,6,wolkig
27/10/2016 03:00,31,21,10,9,7,wolkig
27/10/2016 04:00,30,21,9,9,7,wolkig
27/10/2016 05:00,82,37,45,9,6,wolkig
27/10/2016 06:00,335,146,189,9,7,wolkig
27/10/2016 07:00,1019,713,306,10,9,wolkig
27/10/2016 08:00,941,667,274,10,9,wolkig
27/10/2016 09:00,796,576,220,10,9,wolkig
27/10/2016 10:00,571,355,216,10,11,wolkig
27/10/2016 11:00,608,348,260,11,11,wolkig
27/10/2016 12:00,680,332,348,12,13,wolkig
27/10/2016 13:00,804,403,401,12,13,wolkig
27/10/2016 14:00,793,353,440,12,15,wolkig
27/10/2016 15:00,959,446,513,12,17,wolkig
27/10/2016 16:00,1140,512,628,12,11,wolkig
27/10/2016 17:00,1165,511,654,12,13,wolkig
27/10/2016 18:00,1016,461,555,11,11,wolkig
27/10/2016 19:00,844,374,470,11,9,wolkig
27/10/2016 20:00,526,207,319,11,13,wolkig
27/10/2016 21:00,389,174,215,11,13,wolkig
27/10/2016 22:00,395,206,189,11,11,teilweise bewölkt
27/10/2016 23:00,171,91,80,11,17,wolkig
28/10/2016 00:00,92,46,46,11,17,wolkig
28/10/2016 01:00,53,30,23,12,15,wolkig
28/10/2016 02:00,33,17,16,11,15,teilweise bewölkt
28/10/2016 03:00,12,8,4,12,17,wolkig
28/10/2016 04:00,16,6,10,12,19,wolkig
28/10/2016 05:00,75,32,43,12,19,wolkig
28/10/2016 06:00,309,144,165,12,17,wolkig
28/10/2016 07:00,933,643,290,12,17,wolkig
28/10/2016 08:00,812,552,260,12,19,wolkig
28/10/2016 09:00,689,495,194,12,19,wolkig
28/10/2016 10:00,568,345,223,13,19,wolkig
28/10/2016 11:00,645,373,272,13,22,wolkig
28/10/2016 12:00,820,406,414,13,24,Regen
28/10/2016 13:00,940,408,532,13,24,Regen
28/10/2016 14:00,938,426,512,13,19,Regen
28/10/2016 15:00,955,416,539,13,20,wolkig
28/10/2016 16:00,871,378,493,13,19,Regen
28/10/2016 17:00,898,432,466,13,17,Regen
28/10/2016 18:00,762,340,422,13,15,Regen
28/10/2016 19:00,610,271,339,13,11,wolkig
28/10/2016 20:00,452,232,220,12,9,wolkig
28/10/2016 21:00,326,160,166,12,11,wolkig
28/10/2016 22:00,332,169,163,11,11,wolkig
28/10/2016 23:00,261,91,170,9,7,
29/10/2016 00:00,180,80,100,8,7,Nebel
29/10/2016 01:00,168,61,107,8,7,Nebel
29/10/2016 02:00,118,59,59,6,6,Nebel
29/10/2016 03:00,73,42,31,7,6,Nebel
29/10/2016 04:00,56,32,24,6,4,Nebel
29/10/2016 05:00,46,27,19,7,6,Nebel
29/10/2016 06:00,58,28,30,6,9,Nebel
29/10/2016 07:00,122,74,48,6,0,Nebel
29/10/2016 08:00,239,132,107,5,0,Nebel
29/10/2016 09:00,440,300,140,8,0,Nebel
29/10/2016 10:00,565,360,205,9,6,teilweise bewölkt
29/10/2016 11:00,769,476,293,11,7,teilweise bewölkt
29/10/2016 12:00,823,446,377,12,13,teilweise bewölkt
29/10/2016 13:00,852,436,416,13,13,teilweise bewölkt
29/10/2016 14:00,809,386,423,14,13,teilweise bewölkt
29/10/2016 15:00,700,309,391,13,9,teilweise bewölkt
29/10/2016 16:00,666,270,396,13,6,teilweise bewölkt
29/10/2016 17:00,692,299,393,11,6,teilweise bewölkt
29/10/2016 18:00,694,319,375,9,4,teilweise bewölkt
29/10/2016 19:00,509,219,290,8,6,teilweise bewölkt
29/10/2016 20:00,386,184,202,7,2,Nebel
29/10/2016 21:00,301,147,154,5,0,Nebel
29/10/2016 22:00,313,171,142,5,0,Nebel
29/10/2016 23:00,250,134,116,5,2,Klarer Himmel
30/10/2016 00:00,183,85,98,7,0,Klarer Himmel
30/10/2016 01:00,192,100,92,6,2,Nebel
30/10/2016 02:00,231,107,124,6,2,Nebel
30/10/2016 03:00,58,20,38,4,0,Nebel
30/10/2016 04:00,48,29,19,5,4,Nebel
30/10/2016 05:00,32,17,15,6,9,wolkig
30/10/2016 06:00,40,24,16,5,4,Nebel
30/10/2016 07:00,44,19,25,6,4,wolkig
30/10/2016 08:00,108,50,58,7,2,
30/10/2016 09:00,192,106,86,8,2,wolkig
30/10/2016 10:00,246,135,111,9,4,wolkig
30/10/2016 11:00,291,171,120,10,6,wolkig
30/10/2016 12:00,322,184,138,12,4,wolkig
30/10/2016 13:00,400,222,178,12,2,wolkig
30/10/2016 14:00,475,258,217,12,7,wolkig
30/10/2016 15:00,499,269,230,12,2,wolkig
30/10/2016 16:00,502,247,255,9,2,Nebel
30/10/2016 17:00,522,258,264,8,0,Nebel
30/10/2016 18:00,421,225,196,9,0,wolkig
30/10/2016 19:00,322,169,153,9,4,wolkig
30/10/2016 20:00,250,130,120,9,4,wolkig
30/10/2016 21:00,200,114,86,9,4,wolkig
30/10/2016 22:00,163,105,58,9,6,wolkig
30/10/2016 23:00,89,50,39,,,
31/10/2016 00:00,35,14,21,9,4,wolkig
31/10/2016 01:00,16,9,7,9,4,wolkig
31/10/2016 02:00,7,3,4,9,0,wolkig
31/10/2016 03:00,9,2,7,10,7,wolkig
31/10/2016 04:00,0,0,0,9,2,wolkig
31/10/2016 05:00,63,32,31,9,2,wolkig
31/10/2016 06:00,265,118,147,9,2,wolkig
31/10/2016 07:00,794,523,271,9,2,wolkig
31/10/2016 08:00,712,481,231,10,6,wolkig
31/10/2016 09:00,698,511,187,10,6,wolkig
31/10/2016 10:00,667,418,249,11,2,wolkig
31/10/2016 11:00,747,462,285,13,4,wolkig
31/10/2016 12:00,811,422,389,13,6,wolkig
31/10/2016 13:00,884,446,438,15,6,wolkig
31/10/2016 14:00,849,400,449,15,6,wolkig
31/10/2016 15:00,955,463,492,14,9,wolkig
31/10/2016 16:00,1112,460,652,13,4,wolkig
31/10/2016 17:00,1048,470,578,11,4,teilweise bewölkt
31/10/2016 18:00,928,363,565,9,4,Klarer Himmel
31/10/2016 19:00,774,332,442,8,0,Nebel
31/10/2016 20:00,556,259,297,8,4,Nebel
31/10/2016 21:00,409,198,211,6,2,Nebel
31/10/2016 22:00,320,174,146,5,2,Nebel
31/10/2016 23:00,270,136,134,6,6,Nebel
01/11/2016 00:00,258,103,155,,,
01/11/2016 01:00,282,113,169,,,
01/11/2016 02:00,203,96,107,,,
01/11/2016 03:00,176,96,80,,,
01/11/2016 04:00,110,77,33,,,
01/11/2016 05:00,76,56,20,,,
01/11/2016 06:00,91,43,48,,,
01/11/2016 07:00,76,30,46,,,
01/11/2016 08:00,128,65,63,,,
01/11/2016 09:00,217,111,106,,,
01/11/2016 10:00,268,136,132,,,
01/11/2016 11:00,350,180,170,,,
01/11/2016 12:00,368,181,187,,,
01/11/2016 13:00,401,208,193,,,
01/11/2016 14:00,413,216,197,,,
01/11/2016 15:00,392,189,203,,,
01/11/2016 16:00,445,181,264,,,
01/11/2016 17:00,478,245,233,,,
01/11/2016 18:00,365,205,160,,,
01/11/2016 19:00,317,166,151,,,
01/11/2016 20:00,261,143,118,,,
01/11/2016 21:00,224,139,85,,,
01/11/2016 22:00,181,113,68,,,
01/11/2016 23:00,100,62,38,,,
02/11/2016 00:00,24,14,10,4,9,Nebel
02/11/2016 01:00,20,9,11,5,9,Klarer Himmel
02/11/2016 02:00,5,1,4,4,9,teilweise bewölkt
02/11/2016 03:00,7,4,3,4,11,teilweise bewölkt
02/11/2016 04:00,16,8,8,4,7,teilweise bewölkt
02/11/2016 05:00,90,43,47,5,15,wolkig
02/11/2016 06:00,375,144,231,5,13,Klarer Himmel
02/11/2016 07:00,954,676,278,6,15,Regen
02/11/2016 08:00,897,635,262,6,17,teilweise bewölkt
02/11/2016 09:00,766,578,188,8,28,wolkig
02/11/2016 10:00,637,399,238,9,26,teilweise bewölkt
02/11/2016 11:00,669,379,290,9,20,Regen
02/11/2016 12:00,724,352,372,10,22,wolkig
02/11/2016 13:00,762,384,378,5,26,Regen
02/11/2016 14:00,812,381,431,10,24,Regen
02/11/2016 15:00,817,365,452,8,20,Regen
02/11/2016 16:00,1007,431,576,8,11,Regen
02/11/2016 17:00,1092,502,590,6,11,teilweise bewölkt
02/11/2016 18:00,975,388,587,6,15,teilweise bewölkt
02/11/2016 19:00,764,333,431,7,15,wolkig
02/11/2016 20:00,457,197,260,6,11,teilweise bewölkt
02/11/2016 21:00,371,153,218,5,6,teilweise bewölkt
02/11/2016 22:00,348,166,182,5,4,wolkig
02/11/2016 23:00,248,84,164,5,0,wolkig
03/11/2016 00:00,154,72,82,6,2,wolkig
03/11/2016 01:00,90,39,51,5,6,wolkig
03/11/2016 02:00,50,35,15,6,7,wolkig
03/11/2016 03:00,50,44,6,6,7,wolkig
03/11/2016 04:00,61,48,13,6,9,wolkig
03/11/2016 05:00,85,40,45,5,4,wolkig
03/11/2016 06:00,350,149,201,3,6,Nebel
03/11/2016 07:00,1073,737,336,4,6,Nebel
03/11/2016 08:00,932,630,302,5,7,wolkig
03/11/2016 09:00,770,566,204,6,7,wolkig
03/11/2016 10:00,631,417,214,7,7,wolkig
03/11/2016 11:00,697,389,308,8,11,teilweise bewölkt
03/11/2016 12:00,752,348,404,9,15,teilweise bewölkt
03/11/2016 13:00,802,410,392,9,17,teilweise bewölkt
03/11/2016 14:00,842,377,465,9,17,teilweise bewölkt
03/11/2016 15:00,969,422,547,8,11,wolkig
03/11/2016 16:00,1080,467,613,8,11,Klarer Himmel
03/11/2016 17:00,1086,494,592,8,7,wolkig
03/11/2016 18:00,1036,441,595,7,7,Klarer Himmel
03/11/2016 19:00,766,325,441,7,7,
03/11/2016 20:00,475,215,260,7,9,
03/11/2016 21:00,331,173,158,7,9,wolkig
03/11/2016 22:00,321,152,169,7,7,wolkig
03/11/2016 23:00,170,81,89,7,11,wolkig
04/11/2016 00:00,86,40,46,7,9,wolkig
04/11/2016 01:00,45,25,20,7,11,wolkig
04/11/2016 02:00,20,13,7,7,13,Klarer Himmel
04/11/2016 03:00,5,1,4,7,15,Klarer Himmel
04/11/2016 04:00,10,4,6,7,15,Klarer Himmel
04/11/2016 05:00,72,32,40,7,13,wolkig
04/11/2016 06:00,319,141,178,7,15,Klarer Himmel
04/11/2016 07:00,991,681,310,7,11,Klarer Himmel
04/11/2016 08:00,788,538,250,7,17,wolkig
04/11/2016 09:00,741,509,232,8,17,Klarer Himmel
04/11/2016 10:00,610,387,223,8,15,Klarer Himmel
04/11/2016 11:00,695,359,336,9,13,wolkig
04/11/2016 12:00,836,406,430,10,15,wolkig
04/11/2016 13:00,948,438,510,10,17,wolkig
04/11/2016 14:00,976,438,538,10,11,Klarer Himmel
04/11/2016 15:00,918,400,518,10,9,Klarer Himmel
04/11/2016 16:00,908,420,488,8,6,Klarer Himmel
04/11/2016 17:00,857,386,471,7,7,Klarer Himmel
04/11/2016 18:00,785,298,487,7,7,Klarer Himmel
04/11/2016 19:00,606,264,342,6,7,Klarer Himmel
04/11/2016 20:00,388,175,213,6,9,Klarer Himmel
04/11/2016 21:00,291,140,151,6,9,Klarer Himmel
04/11/2016 22:00,297,173,124,6,11,Klarer Himmel
04/11/2016 23:00,249,130,119,6,9,Klarer Himmel
05/11/2016 00:00,219,112,107,7,11,wolkig
05/11/2016 01:00,153,73,80,7,9,wolkig
05/11/2016 02:00,79,44,35,7,9,wolkig
05/11/2016 03:00,91,43,48,7,9,wolkig
05/11/2016 04:00,49,33,16,7,7,Regen
05/11/2016 05:00,53,35,18,6,9,Regen
05/11/2016 06:00,61,34,27,7,9,wolkig
05/11/2016 07:00,121,74,47,7,11,Regen
05/11/2016 08:00,206,123,83,7,13,wolkig
05/11/2016 09:00,417,279,138,7,17,wolkig
05/11/2016 10:00,510,303,207,7,13,wolkig
05/11/2016 11:00,536,298,238,8,15,wolkig
05/11/2016 12:00,678,380,298,8,11,wolkig
05/11/2016 13:00,728,367,361,8,17,wolkig
05/11/2016 14:00,689,310,379,9,19,teilweise bewölkt
05/11/2016 15:00,625,283,342,9,11,teilweise bewölkt
05/11/2016 16:00,623,289,334,7,7,wolkig
05/11/2016 17:00,534,217,317,6,7,wolkig
05/11/2016 18:00,444,172,272,6,7,wolkig
05/11/2016 19:00,403,186,217,5,9,Klarer Himmel
05/11/2016 20:00,288,142,146,6,11,wolkig
05/11/2016 21:00,195,106,89,6,13,teilweise bewölkt
05/11/2016 22:00,194,116,78,6,15,wolkig
05/11/2016 23:00,216,107,109,6,13,wolkig
06/11/2016 00:00,169,87,82,6,13,teilweise bewölkt
06/11/2016 01:00,126,72,54,6,15,wolkig
06/11/2016 02:00,81,36,45,5,11,teilweise bewölkt
06/11/2016 03:00,79,46,33,5,15,teilweise bewölkt
06/11/2016 04:00,45,30,15,5,13,wolkig
06/11/2016 05:00,41,27,14,5,19,wolkig
06/11/2016 06:00,23,15,8,5,17,wolkig
06/11/2016 07:00,48,20,28,5,13,wolkig
06/11/2016 08:00,77,34,43,6,19,wolkig
06/11/2016 09:00,144,88,56,6,17,wolkig
06/11/2016 10:00,252,142,110,6,17,wolkig
06/11/2016 11:00,191,108,83,7,19,wolkig
06/11/2016 12:00,311,177,134,7,22,wolkig
06/11/2016 13:00,314,162,152,7,20,wolkig
06/11/2016 14:00,351,187,164,7,20,wolkig
06/11/2016 15:00,328,175,153,7,13,Regen
06/11/2016 16:00,329,173,156,7,15,Regen
06/11/2016 17:00,302,172,130,6,9,Regen
06/11/2016 18:00,297,160,137,6,13,wolkig
06/11/2016 19:00,316,168,148,6,11,wolkig
06/11/2016 20:00,225,144,81,6,9,wolkig
06/11/2016 21:00,178,106,72,6,7,wolkig
06/11/2016 22:00,140,85,55,6,7,wolkig
06/11/2016 23:00,61,41,20,6,4,wolkig
07/11/2016 00:00,29,17,12,6,4,wolkig
07/11/2016 01:00,18,10,8,6,4,wolkig
07/11/2016 02:00,5,3,2,6,4,wolkig
07/11/2016 03:00,2,1,1,6,6,wolkig
07/11/2016 04:00,10,7,3,6,2,wolkig
07/11/2016 05:00,53,24,29,6,4,Regen
07/11/2016 06:00,320,137,183,6,2,Regen
07/11/2016 07:00,965,651,314,6,2,Regen
07/11/2016 08:00,836,585,251,6,2,Regen
07/11/2016 09:00,611,441,170,6,9,Regen
07/11/2016 10:00,470,300,170,6,13,Regen
07/11/2016 11:00,426,251,175,5,9,Regen
07/11/2016 12:00,520,253,267,5,11,Regen
07/11/2016 13:00,590,291,299,5,13,Regen
07/11/2016 14:00,538,246,292,5,7,Regen
07/11/2016 15:00,629,288,341,4,13,Regen
07/11/2016 16:00,794,352,442,4,6,Regen
07/11/2016 17:00,900,409,491,4,13,Regen
07/11/2016 18:00,711,281,430,3,15,Regen
07/11/2016 19:00,496,211,285,3,15,Regen
07/11/2016 20:00,313,119,194,3,15,Regen
07/11/2016 21:00,222,105,117,2,13,Regen
07/11/2016 22:00,175,79,96,2,13,Regen
07/11/2016 23:00,94,44,50,2,11,Regen
08/11/2016 00:00,47,26,21,2,11,Regen
08/11/2016 01:00,23,9,14,2,11,wolkig
08/11/2016 02:00,4,0,4,2,9,Regen
08/11/2016 03:00,6,4,2,2,11,wolkig
08/11/2016 04:00,4,1,3,2,9,wolkig
08/11/2016 05:00,63,29,34,2,9,wolkig
08/11/2016 06:00,319,131,188,2,11,wolkig
08/11/2016 07:00,995,671,324,2,9,wolkig
08/11/2016 08:00,858,600,258,2,7,wolkig
08/11/2016 09:00,659,460,199,2,7,wolkig
08/11/2016 10:00,519,314,205,3,11,wolkig
08/11/2016 11:00,571,344,227,3,7,wolkig
08/11/2016 12:00,627,291,336,3,7,wolkig
08/11/2016 13:00,697,362,335,3,7,wolkig
08/11/2016 14:00,743,348,395,4,13,wolkig
08/11/2016 15:00,887,401,486,3,7,wolkig
08/11/2016 16:00,1013,428,585,2,6,teilweise bewölkt
08/11/2016 17:00,1079,493,586,0,4,Klarer Himmel
08/11/2016 18:00,919,384,535,0,6,wolkig
08/11/2016 19:00,750,313,437,0,6,wolkig
08/11/2016 20:00,437,201,236,0,6,wolkig
08/11/2016 21:00,337,158,179,0,6,
08/11/2016 22:00,305,156,149,0,7,
08/11/2016 23:00,143,73,70,0,7,wolkig
09/11/2016 00:00,73,41,32,1,9,wolkig
09/11/2016 01:00,37,17,20,1,11,Schnee
09/11/2016 02:00,12,5,7,1,7,wolkig
09/11/2016 03:00,14,4,10,1,7,wolkig
09/11/2016 04:00,9,5,4,0,6,teilweise bewölkt
09/11/2016 05:00,82,38,44,0,4,
09/11/2016 06:00,295,107,188,0,4,wolkig
09/11/2016 07:00,1011,695,316,0,6,teilweise bewölkt
09/11/2016 08:00,913,639,274,0,6,teilweise bewölkt
09/11/2016 09:00,720,509,211,1,6,wolkig
09/11/2016 10:00,628,401,227,2,9,teilweise bewölkt
09/11/2016 11:00,608,354,254,3,7,teilweise bewölkt
09/11/2016 12:00,686,345,341,4,7,wolkig
09/11/2016 13:00,757,374,383,4,11,wolkig
09/11/2016 14:00,733,336,397,5,11,Regen
09/11/2016 15:00,792,336,456,4,7,Regen
09/11/2016 16:00,925,403,522,4,6,Regen
09/11/2016 17:00,943,452,491,4,7,Regen
09/11/2016 18:00,786,310,476,3,6,Regen
09/11/2016 19:00,615,263,352,3,7,Regen
09/11/2016 20:00,392,167,225,3,7,Regen
09/11/2016 21:00,294,129,165,3,6,Regen
09/11/2016 22:00,239,139,100,3,6,Regen
09/11/2016 23:00,131,70,61,3,4,wolkig
10/11/2016 00:00,75,37,38,3,4,wolkig
10/11/2016 01:00,47,18,29,3,4,wolkig
10/11/2016 02:00,33,12,21,3,6,wolkig
10/11/2016 03:00,19,7,12,3,4,wolkig
10/11/2016 04:00,20,12,8,3,2,wolkig
10/11/2016 05:00,80,36,44,3,4,wolkig
10/11/2016 06:00,290,109,181,3,4,wolkig
10/11/2016 07:00,928,611,317,3,2,Regen
10/11/2016 08:00,800,552,248,3,2,Regen
10/11/2016 09:00,656,474,182,3,2,Regen
10/11/2016 10:00,413,255,158,4,0,wolkig
10/11/2016 11:00,410,216,194,4,4,wolkig
10/11/2016 12:00,512,244,268,4,7,wolkig
10/11/2016 13:00,603,278,325,4,7,wolkig
10/11/2016 14:00,620,287,333,4,4,wolkig
10/11/2016 15:00,731,353,378,4,6,wolkig
10/11/2016 16:00,909,412,497,4,4,wolkig
10/11/2016 17:00,981,437,544,4,4,wolkig
10/11/2016 18:00,875,393,482,4,4,wolkig
10/11/2016 19:00,660,298,362,4,6,wolkig
10/11/2016 20:00,399,181,218,4,7,wolkig
10/11/2016 21:00,323,142,181,4,7,wolkig
10/11/2016 22:00,281,133,148,4,9,wolkig
10/11/2016 23:00,156,72,84,4,6,wolkig
11/11/2016 00:00,78,30,48,4,7,Regen
11/11/2016 01:00,51,17,34,4,15,Regen
11/11/2016 02:00,35,26,9,3,15,Regen
11/11/2016 03:00,18,12,6,3,13,Regen
11/11/2016 04:00,15,11,4,3,17,Regen
11/11/2016 05:00,80,39,41,3,22,wolkig
11/11/2016 06:00,243,97,146,3,24,wolkig
11/11/2016 07:00,858,582,276,3,17,wolkig
11/11/2016 08:00,760,471,289,2,20,wolkig
11/11/2016 09:00,641,431,210,2,15,wolkig
11/11/2016 10:00,555,343,212,2,19,wolkig
11/11/2016 11:00,572,317,255,3,19,teilweise bewölkt
11/11/2016 12:00,703,340,363,3,11,teilweise bewölkt
11/11/2016 13:00,910,404,506,3,17,teilweise bewölkt
11/11/2016 14:00,824,353,471,3,13,wolkig
11/11/2016 15:00,842,369,473,3,11,wolkig
11/11/2016 16:00,827,344,483,2,7,wolkig
11/11/2016 17:00,780,346,434,2,9,wolkig
11/11/2016 18:00,663,302,361,1,7,wolkig
11/11/2016 19:00,596,246,350,1,4,wolkig
11/11/2016 20:00,354,175,179,1,9,wolkig
11/11/2016 21:00,297,138,159,-1,4,teilweise bewölkt
11/11/2016 22:00,271,158,113,-2,2,
11/11/2016 23:00,229,114,115,-3,0,Nebel
12/11/2016 00:00,169,78,91,-3,0,Nebel
12/11/2016 01:00,112,62,50,-2,4,Nebel
12/11/2016 02:00,104,54,50,-2,4,Nebel
12/11/2016 03:00,59,36,23,-2,7,Nebel
12/11/2016 04:00,56,44,12,-2,6,Nebel
12/11/2016 05:00,48,31,17,-2,4,Nebel
12/11/2016 06:00,49,26,23,-2,6,Nebel
12/11/2016 07:00,118,69,49,-2,7,Nebel
12/11/2016 08:00,208,137,71,-2,9,Nebel
12/11/2016 09:00,418,282,136,-1,7,
12/11/2016 10:00,498,332,166,1,9,
12/11/2016 11:00,592,376,216,2,13,Klarer Himmel
12/11/2016 12:00,644,361,283,3,13,Klarer Himmel
12/11/2016 13:00,715,371,344,3,19,Klarer Himmel
12/11/2016 14:00,678,305,373,3,17,Klarer Himmel
12/11/2016 15:00,678,287,391,3,9,wolkig
12/11/2016 16:00,619,258,361,1,6,Klarer Himmel
12/11/2016 17:00,504,216,288,1,9,wolkig
12/11/2016 18:00,469,177,292,1,9,Klarer Himmel
12/11/2016 19:00,422,190,232,1,11,Klarer Himmel
12/11/2016 20:00,321,161,160,1,9,Klarer Himmel
12/11/2016 21:00,225,122,103,1,7,Klarer Himmel
12/11/2016 22:00,212,95,117,1,11,Klarer Himmel
12/11/2016 23:00,181,89,92,1,7,Klarer Himmel
13/11/2016 00:00,198,94,104,1,7,Klarer Himmel
13/11/2016 01:00,180,84,96,1,7,Klarer Himmel
13/11/2016 02:00,114,63,51,1,7,Klarer Himmel
13/11/2016 03:00,109,68,41,1,7,Klarer Himmel
13/11/2016 04:00,73,49,24,1,7,Klarer Himmel
13/11/2016 05:00,37,24,13,1,11,Klarer Himmel
13/11/2016 06:00,40,23,17,1,9,Klarer Himmel
13/11/2016 07:00,43,17,26,1,11,Klarer Himmel
13/11/2016 08:00,69,29,40,1,7,Klarer Himmel
13/11/2016 09:00,150,81,69,1,9,Klarer Himmel
13/11/2016 10:00,215,128,87,2,9,Klarer Himmel
13/11/2016 11:00,215,115,100,3,11,Klarer Himmel
13/11/2016 12:00,254,140,114,3,7,Klarer Himmel
13/11/2016 13:00,295,167,128,4,7,Klarer Himmel
13/11/2016 14:00,343,167,176,4,6,Klarer Himmel
13/11/2016 15:00,368,229,139,3,6,Klarer Himmel
13/11/2016 16:00,344,191,153,2,6,Klarer Himmel
13/11/2016 17:00,332,185,147,1,6,Klarer Himmel
13/11/2016 18:00,271,148,123,1,6,Klarer Himmel
13/11/2016 19:00,297,143,154,0,4,Klarer Himmel
13/11/2016 20:00,216,136,80,-1,4,Klarer Himmel
13/11/2016 21:00,150,94,56,0,6,Klarer Himmel
13/11/2016 22:00,152,86,66,-1,4,Klarer Himmel
13/11/2016 23:00,90,53,37,-2,4,Klarer Himmel
14/11/2016 00:00,32,21,11,-2,6,Klarer Himmel
14/11/2016 01:00,16,9,7,-2,2,Klarer Himmel
14/11/2016 02:00,7,4,3,-2,2,Klarer Himmel
14/11/2016 03:00,1,0,1,-2,4,Klarer Himmel
14/11/2016 04:00,8,2,6,-3,4,Klarer Himmel
14/11/2016 05:00,80,32,48,-3,4,Klarer Himmel
14/11/2016 06:00,313,126,187,-3,6,Klarer Himmel
14/11/2016 07:00,972,635,337,-3,7,Klarer Himmel
14/11/2016 08:00,872,596,276,-2,6,Klarer Himmel
14/11/2016 09:00,682,495,187,0,11,Klarer Himmel
14/11/2016 10:00,555,373,182,2,9,Klarer Himmel
14/11/2016 11:00,539,313,226,3,11,Klarer Himmel
14/11/2016 12:00,666,337,329,4,15,Klarer Himmel
14/11/2016 13:00,691,363,328,4,13,Klarer Himmel
14/11/2016 14:00,690,359,331,4,11,Klarer Himmel
14/11/2016 15:00,829,375,454,4,6,Klarer Himmel
14/11/2016 16:00,1000,439,561,4,6,Klarer Himmel
14/11/2016 17:00,1117,535,582,4,7,wolkig
14/11/2016 18:00,860,352,508,3,6,Regen
14/11/2016 19:00,665,278,387,4,11,Regen
14/11/2016 20:00,414,186,228,4,15,Regen
14/11/2016 21:00,292,152,140,4,17,Regen
14/11/2016 22:00,227,105,122,3,17,wolkig
14/11/2016 23:00,104,50,54,3,15,Regen
15/11/2016 00:00,61,36,25,3,13,Regen
15/11/2016 01:00,14,7,7,3,11,Regen
15/11/2016 02:00,7,5,2,3,11,Regen
15/11/2016 03:00,3,1,2,3,11,Regen
15/11/2016 04:00,12,6,6,4,11,Regen
15/11/2016 05:00,82,38,44,5,11,Regen
15/11/2016 06:00,284,109,175,5,11,Regen
15/11/2016 07:00,903,614,289,6,13,Regen
15/11/2016 08:00,800,561,239,6,13,Regen
15/11/2016 09:00,588,433,155,6,15,Regen
15/11/2016 10:00,419,253,166,7,13,Regen
15/11/2016 11:00,437,256,181,7,15,Regen
15/11/2016 12:00,516,257,259,8,17,Regen
15/11/2016 13:00,558,265,293,8,15,Regen
15/11/2016 14:00,587,293,294,9,15,Regen
15/11/2016 15:00,711,342,369,9,13,Regen
15/11/2016 16:00,843,342,501,9,15,wolkig
15/11/2016 17:00,908,405,503,10,15,Regen
15/11/2016 18:00,822,324,498,,,
15/11/2016 19:00,614,252,362,10,11,Regen
15/11/2016 20:00,444,201,243,10,11,Regen
15/11/2016 21:00,310,149,161,10,11,Regen
15/11/2016 22:00,268,152,116,10,9,Regen
15/11/2016 23:00,131,62,69,10,9,wolkig
16/11/2016 00:00,66,32,34,10,6,Regen
16/11/2016 01:00,31,14,17,10,6,wolkig
16/11/2016 02:00,13,8,5,10,7,wolkig
16/11/2016 03:00,8,5,3,10,7,Nebel
16/11/2016 04:00,10,4,6,10,7,Nebel
16/11/2016 05:00,88,34,54,10,7,Regen
16/11/2016 06:00,340,136,204,10,11,Regen
16/11/2016 07:00,898,603,295,10,13,Regen
16/11/2016 08:00,838,569,269,11,15,Regen
16/11/2016 09:00,564,400,164,12,17,Regen
16/11/2016 10:00,463,292,171,13,19,wolkig
16/11/2016 11:00,468,289,179,13,20,Regen
16/11/2016 12:00,598,303,295,13,19,Regen
16/11/2016 13:00,676,334,342,13,20,wolkig
16/11/2016 14:00,650,302,348,13,24,wolkig
16/11/2016 15:00,753,335,418,13,24,wolkig
16/11/2016 16:00,854,344,510,12,17,wolkig
16/11/2016 17:00,931,432,499,12,17,wolkig
16/11/2016 18:00,895,370,525,12,15,wolkig
16/11/2016 19:00,657,260,397,12,24,wolkig
16/11/2016 20:00,420,187,233,11,19,wolkig
16/11/2016 21:00,334,150,184,11,20,teilweise bewölkt
16/11/2016 22:00,267,123,144,11,17,teilweise bewölkt
16/11/2016 23:00,182,91,91,11,20,wolkig
17/11/2016 00:00,141,47,94,11,24,Regen
17/11/2016 01:00,73,20,53,10,20,wolkig
17/11/2016 02:00,43,29,14,9,11,wolkig
17/11/2016 03:00,45,34,11,9,11,Regen
17/11/2016 04:00,49,45,4,9,9,Regen
17/11/2016 05:00,78,47,31,8,6,Regen
17/11/2016 06:00,267,94,173,8,6,Regen
17/11/2016 07:00,842,574,268,8,6,wolkig
17/11/2016 08:00,795,545,250,8,13,Regen
17/11/2016 09:00,647,473,174,9,15,wolkig
17/11/2016 10:00,504,321,183,9,17,wolkig
17/11/2016 11:00,552,337,215,10,22,wolkig
17/11/2016 12:00,692,356,336,11,20,wolkig
17/11/2016 13:00,732,361,371,11,24,wolkig
17/11/2016 14:00,666,305,361,10,22,wolkig
17/11/2016 15:00,763,328,435,10,17,teilweise bewölkt
17/11/2016 16:00,882,363,519,9,20,wolkig
17/11/2016 17:00,931,421,510,9,19,wolkig
17/11/2016 18:00,853,376,477,11,26,Regen
17/11/2016 19:00,600,261,339,10,28,Regen
17/11/2016 20:00,402,172,230,10,24,Regen
17/11/2016 21:00,307,147,160,11,20,wolkig
17/11/2016 22:00,260,127,133,12,22,wolkig
17/11/2016 23:00,184,85,99,11,22,wolkig
18/11/2016 00:00,68,39,29,11,19,Regen
18/11/2016 01:00,50,27,23,8,24,Regen
18/11/2016 02:00,26,16,10,8,7,Regen
18/11/2016 03:00,24,20,4,7,9,Regen
18/11/2016 04:00,13,9,4,7,4,Regen
18/11/2016 05:00,59,27,32,6,19,Regen
18/11/2016 06:00,260,102,158,6,13,teilweise bewölkt
18/11/2016 07:00,800,538,262,5,17,wolkig
18/11/2016 08:00,691,462,229,5,15,teilweise bewölkt
18/11/2016 09:00,647,449,198,6,19,teilweise bewölkt
18/11/2016 10:00,556,354,202,8,20,wolkig
18/11/2016 11:00,586,320,266,9,22,wolkig
18/11/2016 12:00,714,331,383,8,22,teilweise bewölkt
18/11/2016 13:00,877,410,467,9,28,teilweise bewölkt
18/11/2016 14:00,837,391,446,9,26,teilweise bewölkt
18/11/2016 15:00,836,377,459,8,28,teilweise bewölkt
18/11/2016 16:00,755,335,420,7,20,teilweise bewölkt
18/11/2016 17:00,750,325,425,6,11,Klarer Himmel
18/11/2016 18:00,723,301,422,6,9,Regen
18/11/2016 19:00,590,244,346,5,19,teilweise bewölkt
18/11/2016 20:00,372,169,203,6,30,wolkig
18/11/2016 21:00,291,172,119,6,19,wolkig
18/11/2016 22:00,245,132,113,6,17,wolkig
18/11/2016 23:00,227,123,104,5,9,teilweise bewölkt
19/11/2016 00:00,167,93,74,6,9,wolkig
19/11/2016 01:00,169,77,92,4,9,teilweise bewölkt
19/11/2016 02:00,119,58,61,4,13,teilweise bewölkt
19/11/2016 03:00,71,34,37,4,13,teilweise bewölkt
19/11/2016 04:00,65,38,27,4,11,teilweise bewölkt
19/11/2016 05:00,60,37,23,4,11,teilweise bewölkt
19/11/2016 06:00,51,28,23,5,15,wolkig
19/11/2016 07:00,123,80,43,5,15,wolkig
19/11/2016 08:00,245,130,115,6,7,wolkig
19/11/2016 09:00,430,293,137,6,13,wolkig
19/11/2016 10:00,505,328,177,7,15,Regen
19/11/2016 11:00,540,330,210,6,17,Regen
19/11/2016 12:00,601,323,278,7,19,teilweise bewölkt
19/11/2016 13:00,620,314,306,7,22,teilweise bewölkt
19/11/2016 14:00,642,307,335,7,26,teilweise bewölkt
19/11/2016 15:00,598,246,352,7,17,teilweise bewölkt
19/11/2016 16:00,524,235,289,6,11,
19/11/2016 17:00,549,230,319,6,11,Klarer Himmel
19/11/2016 18:00,487,208,279,5,7,Klarer Himmel
19/11/2016 19:00,391,188,203,5,11,Klarer Himmel
19/11/2016 20:00,354,157,197,5,9,teilweise bewölkt
19/11/2016 21:00,220,121,99,4,9,teilweise bewölkt
19/11/2016 22:00,211,118,93,5,11,wolkig
19/11/2016 23:00,214,111,103,5,13,wolkig
20/11/2016 00:00,201,74,127,5,15,Klarer Himmel
20/11/2016 01:00,178,90,88,4,11,Klarer Himmel
20/11/2016 02:00,102,56,46,4,13,Klarer Himmel
20/11/2016 03:00,114,71,43,5,11,Klarer Himmel
20/11/2016 04:00,71,45,26,5,13,Klarer Himmel
20/11/2016 05:00,51,32,19,5,13,Klarer Himmel
20/11/2016 06:00,44,30,14,5,17,Klarer Himmel
20/11/2016 07:00,45,18,27,6,22,Klarer Himmel
20/11/2016 08:00,80,42,38,7,24,wolkig
20/11/2016 09:00,106,62,44,7,22,Regen
20/11/2016 10:00,125,67,58,7,17,wolkig
20/11/2016 11:00,172,94,78,10,30,teilweise bewölkt
20/11/2016 12:00,171,96,75,11,30,wolkig
20/11/2016 13:00,280,146,134,13,32,wolkig
20/11/2016 14:00,259,144,115,14,35,Klarer Himmel
20/11/2016 15:00,318,167,151,14,30,Klarer Himmel
20/11/2016 16:00,302,164,138,14,35,Klarer Himmel
20/11/2016 17:00,288,170,118,14,28,wolkig
20/11/2016 18:00,291,148,143,12,26,wolkig
20/11/2016 19:00,287,157,130,12,26,teilweise bewölkt
20/11/2016 20:00,171,104,67,12,19,wolkig
20/11/2016 21:00,158,99,59,11,7,teilweise bewölkt
20/11/2016 22:00,138,88,50,12,11,wolkig
20/11/2016 23:00,89,59,30,11,13,Regen
21/11/2016 00:00,30,20,10,10,6,Regen
21/11/2016 01:00,5,3,2,10,6,teilweise bewölkt
21/11/2016 02:00,7,2,5,10,7,wolkig
21/11/2016 03:00,3,1,2,10,11,wolkig
21/11/2016 04:00,11,4,7,10,11,wolkig
21/11/2016 05:00,81,37,44,11,11,Regen
21/11/2016 06:00,312,131,181,12,11,wolkig
21/11/2016 07:00,937,628,309,12,11,wolkig
21/11/2016 08:00,804,528,276,12,13,Regen
21/11/2016 09:00,665,484,181,13,17,Regen
21/11/2016 10:00,481,306,175,12,13,Regen
21/11/2016 11:00,460,268,192,13,20,Regen
21/11/2016 12:00,553,269,284,12,9,Regen
21/11/2016 13:00,629,303,326,12,6,Regen
21/11/2016 14:00,607,328,279,13,11,Regen
21/11/2016 15:00,791,384,407,13,9,Regen
21/11/2016 16:00,911,422,489,13,11,wolkig
21/11/2016 17:00,1108,548,560,13,11,Klarer Himmel
21/11/2016 18:00,909,404,505,12,7,Klarer Himmel
21/11/2016 19:00,763,303,460,12,9,Klarer Himmel
21/11/2016 20:00,476,186,290,12,7,wolkig
21/11/2016 21:00,278,142,136,13,7,wolkig
21/11/2016 22:00,286,164,122,13,11,wolkig
21/11/2016 23:00,139,64,75,14,22,Klarer Himmel
22/11/2016 00:00,52,23,29,14,20,Klarer Himmel
22/11/2016 01:00,22,14,8,14,22,Klarer Himmel
22/11/2016 02:00,6,2,4,13,17,Klarer Himmel
22/11/2016 03:00,6,4,2,13,22,Klarer Himmel
22/11/2016 04:00,12,3,9,13,15,Klarer Himmel
22/11/2016 05:00,83,42,41,12,13,Klarer Himmel
22/11/2016 06:00,339,140,199,11,9,Klarer Himmel
22/11/2016 07:00,1017,675,342,10,9,Klarer Himmel
22/11/2016 08:00,930,643,287,11,9,Klarer Himmel
22/11/2016 09:00,741,543,198,12,9,Klarer Himmel
22/11/2016 10:00,562,344,218,12,11,Klarer Himmel
22/11/2016 11:00,605,374,231,13,11,Klarer Himmel
22/11/2016 12:00,723,347,376,14,13,Klarer Himmel
22/11/2016 13:00,753,357,396,14,13,Klarer Himmel
22/11/2016 14:00,787,339,448,13,11,Klarer Himmel
22/11/2016 15:00,945,450,495,12,7,Klarer Himmel
22/11/2016 16:00,1018,492,526,12,7,Klarer Himmel
22/11/2016 17:00,1152,551,601,11,6,Klarer Himmel
22/11/2016 18:00,1004,429,575,11,6,Klarer Himmel
22/11/2016 19:00,836,349,487,11,4,Regen
22/11/2016 20:00,550,218,332,10,4,Regen
22/11/2016 21:00,302,139,163,9,7,Regen
22/11/2016 22:00,334,172,162,9,7,Klarer Himmel
22/11/2016 23:00,190,119,71,9,4,wolkig
23/11/2016 00:00,75,38,37,9,2,wolkig
23/11/2016 01:00,32,6,26,8,2,
23/11/2016 02:00,33,9,24,9,2,wolkig
23/11/2016 03:00,14,5,9,9,0,wolkig
23/11/2016 04:00,25,7,18,8,2,wolkig
23/11/2016 05:00,72,35,37,9,0,wolkig
23/11/2016 06:00,337,137,200,8,0,teilweise bewölkt
23/11/2016 07:00,983,662,321,7,0,Nebel
23/11/2016 08:00,983,678,305,7,0,Nebel
23/11/2016 09:00,772,548,224,7,2,Nebel
23/11/2016 10:00,630,411,219,9,2,Klarer Himmel
23/11/2016 11:00,667,396,271,10,4,Klarer Himmel
23/11/2016 12:00,748,379,369,12,7,Klarer Himmel
23/11/2016 13:00,820,393,427,12,6,Klarer Himmel
23/11/2016 14:00,856,375,481,12,4,Klarer Himmel
23/11/2016 15:00,906,433,473,11,9,Klarer Himmel
23/11/2016 16:00,1036,460,576,9,6,Klarer Himmel
23/11/2016 17:00,1139,560,579,9,6,Klarer Himmel
23/11/2016 18:00,985,446,539,9,4,Klarer Himmel
23/11/2016 19:00,785,347,438,8,7,Klarer Himmel
23/11/2016 20:00,509,205,304,9,9,Klarer Himmel
23/11/2016 21:00,328,151,177,9,9,Klarer Himmel
23/11/2016 22:00,326,147,179,9,7,Klarer Himmel
23/11/2016 23:00,184,90,94,8,11,Klarer Himmel
24/11/2016 00:00,101,41,60,8,11,Klarer Himmel
24/11/2016 01:00,61,21,40,8,11,Klarer Himmel
24/11/2016 02:00,31,14,17,8,9,Klarer Himmel
24/11/2016 03:00,34,19,15,8,17,Klarer Himmel
24/11/2016 04:00,42,23,19,7,17,Klarer Himmel
24/11/2016 05:00,78,37,41,8,13,wolkig
24/11/2016 06:00,346,137,209,8,20,wolkig
24/11/2016 07:00,985,657,328,7,19,wolkig
24/11/2016 08:00,887,600,287,7,17,wolkig
24/11/2016 09:00,742,555,187,7,17,wolkig
24/11/2016 10:00,548,351,197,7,17,wolkig
24/11/2016 11:00,617,343,274,7,15,wolkig
24/11/2016 12:00,700,328,372,7,13,wolkig
24/11/2016 13:00,745,356,389,7,19,wolkig
24/11/2016 14:00,863,399,464,7,22,wolkig
24/11/2016 15:00,905,396,509,7,20,Klarer Himmel
24/11/2016 16:00,1149,525,624,6,17,Klarer Himmel
24/11/2016 17:00,1105,514,591,6,19,Klarer Himmel
24/11/2016 18:00,957,461,496,5,13,Klarer Himmel
24/11/2016 19:00,748,306,442,5,11,Klarer Himmel
24/11/2016 20:00,465,174,291,5,13,teilweise bewölkt
24/11/2016 21:00,367,146,221,4,15,Klarer Himmel
24/11/2016 22:00,292,139,153,4,9,Klarer Himmel
24/11/2016 23:00,198,101,97,3,17,Klarer Himmel
25/11/2016 00:00,148,92,56,3,11,Klarer Himmel
25/11/2016 01:00,74,36,38,2,7,Klarer Himmel
25/11/2016 02:00,47,6,41,2,9,Klarer Himmel
25/11/2016 03:00,33,8,25,1,9,teilweise bewölkt
25/11/2016 04:00,24,9,15,1,13,teilweise bewölkt
25/11/2016 05:00,72,36,36,1,11,
25/11/2016 06:00,279,123,156,1,11,Klarer Himmel
25/11/2016 07:00,873,596,277,2,6,Klarer Himmel
25/11/2016 08:00,786,547,239,2,9,Klarer Himmel
25/11/2016 09:00,659,445,214,3,13,Klarer Himmel
25/11/2016 10:00,587,363,224,4,13,Klarer Himmel
25/11/2016 11:00,642,366,276,6,11,Klarer Himmel
25/11/2016 12:00,801,413,388,7,13,Klarer Himmel
25/11/2016 13:00,924,410,514,6,17,Klarer Himmel
25/11/2016 14:00,923,440,483,6,15,Klarer Himmel
25/11/2016 15:00,978,448,530,4,11,Klarer Himmel
25/11/2016 16:00,848,385,463,2,11,Klarer Himmel
25/11/2016 17:00,908,412,496,1,7,Klarer Himmel
25/11/2016 18:00,771,365,406,1,6,Klarer Himmel
25/11/2016 19:00,610,278,332,0,11,Klarer Himmel
25/11/2016 20:00,432,173,259,0,6,
25/11/2016 21:00,328,137,191,0,6,
25/11/2016 22:00,277,147,130,-1,7,
25/11/2016 23:00,222,101,121,0,6,
26/11/2016 00:00,197,103,94,-1,2,
26/11/2016 01:00,125,59,66,-2,4,Nebel
26/11/2016 02:00,112,54,58,-2,2,
26/11/2016 03:00,76,31,45,-3,6,Nebel
26/11/2016 04:00,43,25,18,-3,6,Nebel
26/11/2016 05:00,58,29,29,-3,4,Nebel
26/11/2016 06:00,58,25,33,-4,0,Nebel
26/11/2016 07:00,122,72,50,-3,2,Nebel
26/11/2016 08:00,214,117,97,-3,4,Nebel
26/11/2016 09:00,399,293,106,-3,2,Nebel
26/11/2016 10:00,522,344,178,-1,2,wolkig
26/11/2016 11:00,623,373,250,-1,9,Nebel
26/11/2016 12:00,703,400,303,-1,4,Nebel
26/11/2016 13:00,716,332,384,-1,6,Nebel
26/11/2016 14:00,620,259,361,-1,6,Nebel
26/11/2016 15:00,613,287,326,-1,6,Nebel
26/11/2016 16:00,517,246,271,-1,4,Nebel
26/11/2016 17:00,525,242,283,-1,2,Nebel
26/11/2016 18:00,535,206,329,-2,4,Nebel
26/11/2016 19:00,468,184,284,-2,4,Nebel
26/11/2016 20:00,365,141,224,-2,4,Nebel
26/11/2016 21:00,291,109,182,-1,0,wolkig
26/11/2016 22:00,183,101,82,-1,4,wolkig
26/11/2016 23:00,217,139,78,-1,4,wolkig
27/11/2016 00:00,175,80,95,0,2,Regen
27/11/2016 01:00,182,94,88,0,2,wolkig
27/11/2016 02:00,89,44,45,0,0,Regen
27/11/2016 03:00,67,32,35,1,0,wolkig
27/11/2016 04:00,59,42,17,1,4,wolkig
27/11/2016 05:00,39,29,10,2,0,Nebel
27/11/2016 06:00,48,31,17,2,4,wolkig
27/11/2016 07:00,54,30,24,4,7,wolkig
27/11/2016 08:00,64,29,35,4,9,wolkig
27/11/2016 09:00,128,68,60,5,11,wolkig
27/11/2016 10:00,241,139,102,6,9,wolkig
27/11/2016 11:00,224,127,97,7,9,wolkig
27/11/2016 12:00,263,139,124,8,9,wolkig
27/11/2016 13:00,296,165,131,8,9,wolkig
27/11/2016 14:00,363,205,158,9,7,wolkig
27/11/2016 15:00,401,234,167,7,6,wolkig
27/11/2016 16:00,378,205,173,4,0,Nebel
27/11/2016 17:00,395,227,168,3,0,Nebel
27/11/2016 18:00,361,205,156,1,0,Nebel
27/11/2016 19:00,373,202,171,0,0,Nebel
27/11/2016 20:00,248,131,117,-1,6,Nebel
27/11/2016 21:00,188,117,71,0,11,Klarer Himmel
27/11/2016 22:00,136,83,53,1,11,Klarer Himmel
27/11/2016 23:00,85,51,34,0,6,Klarer Himmel
28/11/2016 00:00,50,28,22,-1,6,Nebel
28/11/2016 01:00,17,12,5,-2,2,Nebel
28/11/2016 02:00,5,3,2,-3,4,Nebel
28/11/2016 03:00,6,2,4,-5,7,Nebel
28/11/2016 04:00,15,7,8,-3,2,Nebel
28/11/2016 05:00,89,41,48,-5,6,Nebel
28/11/2016 06:00,316,125,191,-5,4,Nebel
28/11/2016 07:00,916,632,284,-4,2,Klarer Himmel
28/11/2016 08:00,829,563,266,-5,7,Klarer Himmel
28/11/2016 09:00,670,493,177,-1,7,Klarer Himmel
28/11/2016 10:00,591,375,216,1,11,Klarer Himmel
28/11/2016 11:00,578,335,243,2,13,Klarer Himmel
28/11/2016 12:00,650,334,316,3,13,Klarer Himmel
28/11/2016 13:00,762,401,361,3,7,teilweise bewölkt
28/11/2016 14:00,721,383,338,3,9,Klarer Himmel
28/11/2016 15:00,903,422,481,2,7,Klarer Himmel
28/11/2016 16:00,990,448,542,0,6,Klarer Himmel
28/11/2016 17:00,1048,508,540,-2,2,Klarer Himmel
28/11/2016 18:00,912,405,507,-3,2,Klarer Himmel
28/11/2016 19:00,726,294,432,-4,2,Klarer Himmel
28/11/2016 20:00,440,161,279,-4,2,Klarer Himmel
28/11/2016 21:00,279,128,151,-5,2,Nebel
28/11/2016 22:00,267,107,160,-4,6,Nebel
28/11/2016 23:00,117,50,67,-5,6,Nebel
29/11/2016 00:00,45,20,25,-5,0,Nebel
29/11/2016 01:00,38,22,16,-5,0,Nebel
29/11/2016 02:00,7,3,4,-6,2,Nebel
29/11/2016 03:00,6,2,4,-7,0,Nebel
29/11/2016 04:00,13,6,7,-7,2,Nebel
29/11/2016 05:00,77,33,44,-7,2,Nebel
29/11/2016 06:00,305,123,182,-7,0,Nebel
29/11/2016 07:00,917,631,286,-7,0,Nebel
29/11/2016 08:00,884,619,265,-7,0,
29/11/2016 09:00,680,514,166,-5,2,
29/11/2016 10:00,510,333,177,-2,2,Klarer Himmel
29/11/2016 11:00,539,325,214,0,4,Klarer Himmel
29/11/2016 12:00,656,325,331,1,4,Klarer Himmel
29/11/2016 13:00,684,327,357,1,6,Klarer Himmel
29/11/2016 14:00,771,346,425,2,4,Klarer Himmel
29/11/2016 15:00,815,370,445,0,2,Klarer Himmel
29/11/2016 16:00,957,426,531,-3,2,Nebel
29/11/2016 17:00,1054,487,567,-3,0,Nebel
29/11/2016 18:00,973,415,558,-4,6,Nebel
29/11/2016 19:00,755,300,455,-5,4,Nebel
29/11/2016 20:00,493,176,317,-6,2,Nebel
29/11/2016 21:00,343,151,192,-6,4,Nebel
29/11/2016 22:00,310,167,143,-6,6,Klarer Himmel
29/11/2016 23:00,161,78,83,-7,2,Klarer Himmel
30/11/2016 00:00,67,34,33,-7,2,Klarer Himmel
30/11/2016 01:00,25,10,15,-7,0,Klarer Himmel
30/11/2016 02:00,14,10,4,-8,7,Klarer Himmel
30/11/2016 03:00,9,3,6,-8,2,Klarer Himmel
30/11/2016 04:00,12,4,8,-7,4,Klarer Himmel
30/11/2016 05:00,73,30,43,-7,4,Klarer Himmel
30/11/2016 06:00,330,135,195,-6,2,Klarer Himmel
30/11/2016 07:00,934,628,306,-7,2,Klarer Himmel
30/11/2016 08:00,893,606,287,-7,4,Klarer Himmel
30/11/2016 09:00,734,532,202,-4,4,wolkig
30/11/2016 10:00,577,369,208,-2,7,wolkig
30/11/2016 11:00,649,392,257,0,11,wolkig
30/11/2016 12:00,632,291,341,2,13,wolkig
30/11/2016 13:00,751,367,384,2,15,wolkig
30/11/2016 14:00,753,354,399,2,19,wolkig
30/11/2016 15:00,806,373,433,2,17,wolkig
30/11/2016 16:00,888,422,466,3,19,wolkig
30/11/2016 17:00,959,467,492,3,17,wolkig
30/11/2016 18:00,951,440,511,4,17,wolkig
30/11/2016 19:00,758,328,430,3,17,wolkig
30/11/2016 20:00,480,191,289,4,17,wolkig
30/11/2016 21:00,339,131,208,4,19,wolkig
30/11/2016 22:00,297,124,173,4,15,wolkig
30/11/2016 23:00,175,67,108,4,19,wolkig
01/12/2016 00:00,112,45,67,4,17,wolkig
01/12/2016 01:00,53,23,30,4,17,wolkig
01/12/2016 02:00,29,9,20,4,22,wolkig
01/12/2016 03:00,11,3,8,4,20,wolkig
01/12/2016 04:00,22,9,13,4,17,wolkig
01/12/2016 05:00,77,35,42,4,17,wolkig
01/12/2016 06:00,329,137,192,4,19,wolkig
01/12/2016 07:00,936,626,310,5,20,wolkig
01/12/2016 08:00,832,567,265,5,20,wolkig
01/12/2016 09:00,679,493,186,5,20,wolkig
01/12/2016 10:00,546,348,198,5,20,wolkig
01/12/2016 11:00,552,332,220,6,24,wolkig
01/12/2016 12:00,611,290,321,6,26,wolkig
01/12/2016 13:00,700,358,342,6,28,wolkig
01/12/2016 14:00,755,372,383,7,24,wolkig
01/12/2016 15:00,849,386,463,7,22,wolkig
01/12/2016 16:00,929,416,513,7,22,wolkig
01/12/2016 17:00,1042,482,560,7,22,wolkig
01/12/2016 18:00,937,451,486,8,24,wolkig
01/12/2016 19:00,670,301,369,8,24,wolkig
01/12/2016 20:00,518,206,312,8,28,wolkig
01/12/2016 21:00,334,123,211,8,20,wolkig
01/12/2016 22:00,291,124,167,8,19,wolkig
01/12/2016 23:00,156,62,94,9,22,wolkig
02/12/2016 00:00,105,50,55,8,19,wolkig
02/12/2016 01:00,47,16,31,8,19,Regen
02/12/2016 02:00,20,2,18,8,20,Regen
02/12/2016 03:00,11,2,9,8,19,Regen
02/12/2016 04:00,20,9,11,7,17,wolkig
02/12/2016 05:00,65,24,41,8,17,Regen
02/12/2016 06:00,296,128,168,8,17,Regen
02/12/2016 07:00,808,546,262,7,9,wolkig
02/12/2016 08:00,772,529,243,8,9,wolkig
02/12/2016 09:00,628,442,186,7,11,teilweise bewölkt
02/12/2016 10:00,559,350,209,8,9,teilweise bewölkt
02/12/2016 11:00,587,333,254,8,11,teilweise bewölkt
02/12/2016 12:00,764,369,395,8,15,teilweise bewölkt
02/12/2016 13:00,932,429,503,8,13,teilweise bewölkt
02/12/2016 14:00,897,409,488,7,13,teilweise bewölkt
02/12/2016 15:00,847,396,451,7,11,Klarer Himmel
02/12/2016 16:00,780,359,421,4,2,Klarer Himmel
02/12/2016 17:00,842,404,438,2,0,Klarer Himmel
02/12/2016 18:00,771,355,416,1,0,Klarer Himmel
02/12/2016 19:00,620,295,325,0,0,Nebel
02/12/2016 20:00,446,199,247,-1,0,Nebel
02/12/2016 21:00,354,147,207,-2,0,Nebel
02/12/2016 22:00,299,147,152,-2,0,Nebel
02/12/2016 23:00,281,126,155,-3,0,Nebel
03/12/2016 00:00,222,103,119,-2,2,Nebel
03/12/2016 01:00,162,60,102,-3,2,Nebel
03/12/2016 02:00,108,49,59,-3,2,
03/12/2016 03:00,86,36,50,-2,4,wolkig
03/12/2016 04:00,71,37,34,-3,0,wolkig
03/12/2016 05:00,61,36,25,-3,4,Nebel
03/12/2016 06:00,73,42,31,-3,2,Nebel
03/12/2016 07:00,110,63,47,-2,4,Nebel
03/12/2016 08:00,231,129,102,-2,2,wolkig
03/12/2016 09:00,408,271,137,-1,4,wolkig
03/12/2016 10:00,496,342,154,0,6,wolkig
03/12/2016 11:00,583,353,230,0,4,wolkig
03/12/2016 12:00,622,347,275,1,4,wolkig
03/12/2016 13:00,668,341,327,2,2,teilweise bewölkt
03/12/2016 14:00,714,321,393,3,4,teilweise bewölkt
03/12/2016 15:00,636,319,317,2,4,teilweise bewölkt
03/12/2016 16:00,609,286,323,0,2,Nebel
03/12/2016 17:00,556,227,329,-2,0,Nebel
03/12/2016 18:00,550,239,311,-2,0,Nebel
03/12/2016 19:00,476,220,256,-3,0,Nebel
03/12/2016 20:00,349,149,200,-3,0,Nebel
03/12/2016 21:00,271,126,145,-4,4,Nebel
03/12/2016 22:00,233,116,117,-4,0,Nebel
03/12/2016 23:00,212,107,105,-4,0,Nebel
04/12/2016 00:00,185,64,121,-5,4,Nebel
04/12/2016 01:00,169,63,106,-5,4,Nebel
04/12/2016 02:00,120,42,78,-4,2,Nebel
04/12/2016 03:00,70,36,34,-5,2,Nebel
04/12/2016 04:00,52,38,14,-6,4,Nebel
04/12/2016 05:00,40,28,12,-5,6,Nebel
04/12/2016 06:00,31,15,16,-6,4,Nebel
04/12/2016 07:00,38,18,20,-6,2,Nebel
04/12/2016 08:00,55,28,27,-6,2,Klarer Himmel
04/12/2016 09:00,155,80,75,-3,0,Klarer Himmel
04/12/2016 10:00,238,147,91,-1,0,Klarer Himmel
04/12/2016 11:00,232,140,92,1,4,Klarer Himmel
04/12/2016 12:00,284,152,132,3,4,Klarer Himmel
04/12/2016 13:00,330,194,136,5,6,Klarer Himmel
04/12/2016 14:00,382,211,171,5,4,Klarer Himmel
04/12/2016 15:00,393,221,172,4,4,Klarer Himmel
04/12/2016 16:00,424,254,170,0,6,Klarer Himmel
04/12/2016 17:00,385,179,206,-2,4,Klarer Himmel
04/12/2016 18:00,333,157,176,-2,6,Klarer Himmel
04/12/2016 19:00,330,165,165,-2,6,Klarer Himmel
04/12/2016 20:00,239,119,120,0,4,Klarer Himmel
04/12/2016 21:00,184,111,73,-1,4,Klarer Himmel
04/12/2016 22:00,134,89,45,-2,6,Klarer Himmel
04/12/2016 23:00,73,41,32,-4,2,Klarer Himmel
05/12/2016 00:00,38,25,13,-4,4,Klarer Himmel
05/12/2016 01:00,15,8,7,-4,4,Klarer Himmel
05/12/2016 02:00,6,4,2,-4,2,Klarer Himmel
05/12/2016 03:00,4,2,2,-4,4,Klarer Himmel
05/12/2016 04:00,14,6,8,-5,2,Klarer Himmel
05/12/2016 05:00,78,37,41,-6,4,Klarer Himmel
05/12/2016 06:00,305,134,171,-7,2,Klarer Himmel
05/12/2016 07:00,849,559,290,-6,0,Klarer Himmel
05/12/2016 08:00,817,568,249,-7,2,Klarer Himmel
05/12/2016 09:00,671,490,181,-4,0,Klarer Himmel
05/12/2016 10:00,562,382,180,0,0,Klarer Himmel
05/12/2016 11:00,556,322,234,2,4,Klarer Himmel
05/12/2016 12:00,686,333,353,4,0,Klarer Himmel
05/12/2016 13:00,714,370,344,4,2,Klarer Himmel
05/12/2016 14:00,700,364,336,5,0,Klarer Himmel
05/12/2016 15:00,825,418,407,4,0,Klarer Himmel
05/12/2016 16:00,1003,436,567,-1,0,Klarer Himmel
05/12/2016 17:00,1089,519,570,-3,0,Klarer Himmel
05/12/2016 18:00,931,401,530,-4,0,Klarer Himmel
05/12/2016 19:00,720,275,445,-4,2,Klarer Himmel
05/12/2016 20:00,474,166,308,-5,0,Klarer Himmel
05/12/2016 21:00,341,152,189,-6,0,Klarer Himmel
05/12/2016 22:00,237,111,126,-6,0,Nebel
05/12/2016 23:00,113,52,61,-7,0,Nebel
06/12/2016 00:00,59,26,33,-7,2,Nebel
06/12/2016 01:00,30,18,12,-7,0,Nebel
06/12/2016 02:00,11,3,8,-7,4,Nebel
06/12/2016 03:00,7,1,6,-7,0,Klarer Himmel
06/12/2016 04:00,9,6,3,-7,2,Klarer Himmel
06/12/2016 05:00,77,38,39,-7,4,Klarer Himmel
06/12/2016 06:00,320,137,183,-7,0,Klarer Himmel
06/12/2016 07:00,928,632,296,-7,2,Klarer Himmel
06/12/2016 08:00,895,607,288,-6,4,Klarer Himmel
06/12/2016 09:00,637,462,175,-3,4,Klarer Himmel
06/12/2016 10:00,510,323,187,-1,4,Klarer Himmel
06/12/2016 11:00,551,334,217,1,6,Klarer Himmel
06/12/2016 12:00,668,323,345,2,6,Klarer Himmel
06/12/2016 13:00,702,334,368,3,6,Klarer Himmel
06/12/2016 14:00,761,350,411,3,4,Klarer Himmel
06/12/2016 15:00,890,409,481,2,2,Klarer Himmel
06/12/2016 16:00,1017,476,541,0,4,Klarer Himmel
06/12/2016 17:00,1060,493,567,0,6,Klarer Himmel
06/12/2016 18:00,961,433,528,0,6,Klarer Himmel
06/12/2016 19:00,744,309,435,-1,6,Klarer Himmel
06/12/2016 20:00,445,174,271,-2,2,Klarer Himmel
06/12/2016 21:00,307,120,187,-1,6,Klarer Himmel
06/12/2016 22:00,316,149,167,-2,7,Klarer Himmel
06/12/2016 23:00,147,77,70,-1,6,Klarer Himmel
07/12/2016 00:00,68,37,31,-2,6,Klarer Himmel
07/12/2016 01:00,31,10,21,-2,6,Klarer Himmel
07/12/2016 02:00,10,3,7,-2,6,Klarer Himmel
07/12/2016 03:00,10,3,7,-2,6,Klarer Himmel
07/12/2016 04:00,13,5,8,-2,7,Klarer Himmel
07/12/2016 05:00,78,41,37,-1,7,Klarer Himmel
07/12/2016 06:00,309,128,181,-1,7,Klarer Himmel
07/12/2016 07:00,891,586,305,-1,9,Klarer Himmel
07/12/2016 08:00,880,587,293,-1,7,Klarer Himmel
07/12/2016 09:00,695,512,183,0,7,wolkig
07/12/2016 10:00,568,361,207,1,9,Klarer Himmel
07/12/2016 11:00,676,402,274,3,9,Klarer Himmel
07/12/2016 12:00,723,374,349,4,11,Klarer Himmel
07/12/2016 13:00,804,391,413,6,6,Klarer Himmel
07/12/2016 14:00,760,356,404,7,9,Klarer Himmel
07/12/2016 15:00,795,389,406,7,9,Klarer Himmel
07/12/2016 16:00,976,444,532,7,9,Klarer Himmel
07/12/2016 17:00,994,488,506,7,9,Klarer Himmel
07/12/2016 18:00,974,449,525,7,9,Klarer Himmel
07/12/2016 19:00,778,322,456,8,11,Klarer Himmel
07/12/2016 20:00,541,194,347,8,11,Klarer Himmel
07/12/2016 21:00,372,160,212,8,13,Klarer Himmel
07/12/2016 22:00,347,166,181,8,19,Klarer Himmel
07/12/2016 23:00,210,74,136,8,17,Klarer Himmel
08/12/2016 00:00,154,61,93,8,19,Klarer Himmel
08/12/2016 01:00,69,18,51,8,17,Klarer Himmel
08/12/2016 02:00,38,22,16,8,15,Klarer Himmel
08/12/2016 03:00,62,36,26,8,17,Klarer Himmel
08/12/2016 04:00,62,50,12,8,15,Klarer Himmel
08/12/2016 05:00,92,52,40,8,13,Klarer Himmel
08/12/2016 06:00,302,120,182,7,13,Klarer Himmel
08/12/2016 07:00,929,629,300,7,15,Klarer Himmel
08/12/2016 08:00,928,628,300,7,17,Klarer Himmel
08/12/2016 09:00,747,564,183,8,19,Klarer Himmel
08/12/2016 10:00,598,384,214,9,22,Klarer Himmel
08/12/2016 11:00,567,337,230,9,19,Klarer Himmel
08/12/2016 12:00,672,333,339,10,15,Klarer Himmel
08/12/2016 13:00,765,386,379,9,13,Klarer Himmel
08/12/2016 14:00,734,337,397,9,13,Klarer Himmel
08/12/2016 15:00,849,371,478,9,13,Klarer Himmel
08/12/2016 16:00,1019,445,574,8,11,Klarer Himmel
08/12/2016 17:00,1107,545,562,8,13,Klarer Himmel
08/12/2016 18:00,949,442,507,8,13,Klarer Himmel
08/12/2016 19:00,780,301,479,8,19,wolkig
08/12/2016 20:00,513,179,334,8,17,wolkig
08/12/2016 21:00,324,143,181,7,19,Regen
08/12/2016 22:00,397,192,205,7,15,Regen
08/12/2016 23:00,214,110,104,7,13,Regen
09/12/2016 00:00,107,49,58,7,15,wolkig
09/12/2016 01:00,46,24,22,7,17,Regen
09/12/2016 02:00,23,12,11,7,17,Regen
09/12/2016 03:00,21,12,9,8,15,Regen
09/12/2016 04:00,22,11,11,8,20,wolkig
09/12/2016 05:00,68,35,33,8,19,Regen
09/12/2016 06:00,269,111,158,8,17,Regen
09/12/2016 07:00,881,603,278,9,17,wolkig
09/12/2016 08:00,750,487,263,9,19,wolkig
09/12/2016 09:00,635,455,180,9,15,wolkig
09/12/2016 10:00,582,372,210,9,15,wolkig
09/12/2016 11:00,635,354,281,9,11,wolkig
09/12/2016 12:00,785,393,392,9,13,wolkig
09/12/2016 13:00,864,378,486,9,13,wolkig
09/12/2016 14:00,930,428,502,9,11,wolkig
09/12/2016 15:00,922,433,489,9,9,Regen
09/12/2016 16:00,802,356,446,10,13,wolkig
09/12/2016 17:00,839,414,425,9,7,wolkig
09/12/2016 18:00,794,411,383,10,13,wolkig
09/12/2016 19:00,660,287,373,10,15,wolkig
09/12/2016 20:00,437,181,256,9,13,Klarer Himmel
09/12/2016 21:00,362,130,232,9,13,Klarer Himmel
09/12/2016 22:00,306,131,175,9,11,Klarer Himmel
09/12/2016 23:00,294,134,160,9,11,Klarer Himmel
10/12/2016 00:00,223,109,114,9,9,Klarer Himmel
10/12/2016 01:00,210,94,116,8,11,Klarer Himmel
10/12/2016 02:00,134,68,66,8,9,Klarer Himmel
10/12/2016 03:00,84,56,28,8,15,Klarer Himmel
10/12/2016 04:00,64,34,30,8,15,Klarer Himmel
10/12/2016 05:00,61,40,21,8,13,Klarer Himmel
10/12/2016 06:00,60,38,22,7,15,Klarer Himmel
10/12/2016 07:00,117,76,41,8,17,Klarer Himmel
10/12/2016 08:00,236,139,97,7,13,Klarer Himmel
10/12/2016 09:00,445,293,152,8,11,wolkig
10/12/2016 10:00,568,392,176,8,13,wolkig
10/12/2016 11:00,670,410,260,8,19,wolkig
10/12/2016 12:00,707,382,325,8,19,Regen
10/12/2016 13:00,704,319,385,7,13,Regen
10/12/2016 14:00,633,277,356,7,13,Regen
10/12/2016 15:00,558,260,298,7,11,Regen
10/12/2016 16:00,491,234,257,7,11,Regen
10/12/2016 17:00,515,237,278,7,7,
10/12/2016 18:00,525,215,310,7,7,Regen
10/12/2016 19:00,398,163,235,8,9,Regen
10/12/2016 20:00,331,150,181,8,9,Regen
10/12/2016 21:00,256,107,149,8,9,Regen
10/12/2016 22:00,188,95,93,8,9,Regen
10/12/2016 23:00,234,116,118,9,11,Regen
11/12/2016 00:00,219,109,110,9,20,Regen
11/12/2016 01:00,129,60,69,9,20,Regen
11/12/2016 02:00,95,40,55,9,26,Regen
11/12/2016 03:00,75,47,28,9,26,Regen
11/12/2016 04:00,55,30,25,9,32,Regen
11/12/2016 05:00,42,28,14,9,35,Regen
11/12/2016 06:00,30,16,14,8,24,wolkig
11/12/2016 07:00,40,20,20,7,22,wolkig
11/12/2016 08:00,65,27,38,7,19,wolkig
11/12/2016 09:00,150,84,66,7,20,wolkig
11/12/2016 10:00,197,110,87,8,22,wolkig
11/12/2016 11:00,238,113,125,9,24,wolkig
11/12/2016 12:00,285,143,142,9,28,wolkig
11/12/2016 13:00,335,191,144,9,26,wolkig
11/12/2016 14:00,303,156,147,8,22,wolkig
11/12/2016 15:00,346,180,166,8,15,Regen
11/12/2016 16:00,354,191,163,8,19,Regen
11/12/2016 17:00,356,203,153,8,20,wolkig
11/12/2016 18:00,365,208,157,7,20,wolkig
11/12/2016 19:00,340,186,154,7,20,Regen
11/12/2016 20:00,262,155,107,7,17,Regen
11/12/2016 21:00,172,107,65,7,15,Regen
11/12/2016 22:00,164,94,70,7,15,wolkig
11/12/2016 23:00,70,36,34,7,17,wolkig
12/12/2016 00:00,41,22,19,7,15,wolkig
12/12/2016 01:00,14,9,5,7,17,wolkig
12/12/2016 02:00,6,1,5,7,13,wolkig
12/12/2016 03:00,7,2,5,7,15,wolkig
12/12/2016 04:00,21,11,10,7,13,Regen
12/12/2016 05:00,78,37,41,7,11,Regen
12/12/2016 06:00,310,134,176,7,9,wolkig
12/12/2016 07:00,924,617,307,6,9,Nebel
12/12/2016 08:00,814,537,277,7,7,wolkig
12/12/2016 09:00,700,516,184,7,9,wolkig
12/12/2016 10:00,581,404,177,8,9,wolkig
12/12/2016 11:00,559,327,232,8,9,wolkig
12/12/2016 12:00,699,348,351,8,9,wolkig
12/12/2016 13:00,781,376,405,8,13,wolkig
12/12/2016 14:00,742,388,354,7,13,wolkig
12/12/2016 15:00,863,404,459,7,9,wolkig
12/12/2016 16:00,1052,502,550,7,4,wolkig
12/12/2016 17:00,1117,539,578,7,9,wolkig
12/12/2016 18:00,920,402,518,7,6,wolkig
12/12/2016 19:00,701,287,414,6,4,wolkig
12/12/2016 20:00,495,157,338,6,6,wolkig
12/12/2016 21:00,277,118,159,6,6,wolkig
12/12/2016 22:00,301,125,176,6,6,wolkig
12/12/2016 23:00,122,54,68,6,7,wolkig
13/12/2016 00:00,75,31,44,6,7,wolkig
13/12/2016 01:00,40,25,15,6,6,wolkig
13/12/2016 02:00,32,22,10,5,7,wolkig
13/12/2016 03:00,8,4,4,5,7,wolkig
13/12/2016 04:00,22,7,15,4,6,wolkig
13/12/2016 05:00,77,32,45,5,7,wolkig
13/12/2016 06:00,340,145,195,5,7,Klarer Himmel
13/12/2016 07:00,927,614,313,6,7,Regen
13/12/2016 08:00,866,580,286,6,7,Regen
13/12/2016 09:00,687,506,181,6,7,wolkig
13/12/2016 10:00,565,377,188,6,7,wolkig
13/12/2016 11:00,561,350,211,6,6,Regen
13/12/2016 12:00,631,300,331,6,11,Regen
13/12/2016 13:00,677,319,358,6,9,Regen
13/12/2016 14:00,749,378,371,6,13,Regen
13/12/2016 15:00,837,394,443,6,9,wolkig
13/12/2016 16:00,977,447,530,6,9,wolkig
13/12/2016 17:00,1051,490,561,6,7,wolkig
13/12/2016 18:00,978,474,504,7,6,wolkig
13/12/2016 19:00,769,314,455,7,7,wolkig
13/12/2016 20:00,480,182,298,7,6,wolkig
13/12/2016 21:00,322,132,190,7,6,wolkig
13/12/2016 22:00,333,143,190,7,7,wolkig
13/12/2016 23:00,162,73,89,7,11,wolkig
14/12/2016 00:00,101,35,66,7,0,wolkig
14/12/2016 01:00,35,18,17,7,4,wolkig
14/12/2016 02:00,18,9,9,7,0,wolkig
14/12/2016 03:00,9,2,7,7,4,Nebel
14/12/2016 04:00,15,6,9,7,6,Nebel
14/12/2016 05:00,80,34,46,7,6,wolkig
14/12/2016 06:00,334,136,198,7,6,wolkig
14/12/2016 07:00,918,610,308,7,4,wolkig
14/12/2016 08:00,890,610,280,7,0,wolkig
14/12/2016 09:00,733,546,187,7,6,wolkig
14/12/2016 10:00,595,380,215,7,6,Nebel
14/12/2016 11:00,612,339,273,8,6,Regen
14/12/2016 12:00,734,382,352,8,6,Regen
14/12/2016 13:00,755,383,372,8,4,wolkig
14/12/2016 14:00,811,389,422,8,7,Nebel
14/12/2016 15:00,855,398,457,8,4,wolkig
14/12/2016 16:00,1006,453,553,8,6,wolkig
14/12/2016 17:00,1067,566,501,8,4,wolkig
14/12/2016 18:00,1001,489,512,8,4,Nebel
14/12/2016 19:00,776,327,449,8,4,wolkig
14/12/2016 20:00,538,182,356,8,6,wolkig
14/12/2016 21:00,363,154,209,8,4,wolkig
14/12/2016 22:00,357,147,210,8,2,wolkig
14/12/2016 23:00,222,105,117,8,7,wolkig
15/12/2016 00:00,138,48,90,7,4,wolkig
15/12/2016 01:00,52,20,32,6,4,teilweise bewölkt
15/12/2016 02:00,37,21,16,6,6,teilweise bewölkt
15/12/2016 03:00,35,18,17,5,6,teilweise bewölkt
15/12/2016 04:00,23,6,17,5,6,teilweise bewölkt
15/12/2016 05:00,74,33,41,5,7,
15/12/2016 06:00,337,127,210,5,9,
15/12/2016 07:00,937,620,317,5,6,
15/12/2016 08:00,867,604,263,4,6,
15/12/2016 09:00,765,553,212,5,9,teilweise bewölkt
15/12/2016 10:00,654,432,222,5,11,wolkig
15/12/2016 11:00,652,371,281,6,11,wolkig
15/12/2016 12:00,724,354,370,6,9,wolkig
15/12/2016 13:00,826,405,421,6,9,wolkig
15/12/2016 14:00,801,371,430,6,9,wolkig
15/12/2016 15:00,937,468,469,6,7,wolkig
15/12/2016 16:00,1046,489,557,6,6,teilweise bewölkt
15/12/2016 17:00,1143,541,602,5,6,Klarer Himmel
15/12/2016 18:00,1047,488,559,5,7,Klarer Himmel
15/12/2016 19:00,793,332,461,4,9,Klarer Himmel
15/12/2016 20:00,556,204,352,4,7,Klarer Himmel
15/12/2016 21:00,373,143,230,4,6,Klarer Himmel
15/12/2016 22:00,337,155,182,4,6,Klarer Himmel
15/12/2016 23:00,215,114,101,3,7,Klarer Himmel
16/12/2016 00:00,141,62,79,3,7,Klarer Himmel
16/12/2016 01:00,73,35,38,3,7,Klarer Himmel
16/12/2016 02:00,47,24,23,2,6,Klarer Himmel
16/12/2016 03:00,36,20,16,2,6,Klarer Himmel
16/12/2016 04:00,36,22,14,2,6,Klarer Himmel
16/12/2016 05:00,75,33,42,2,6,Klarer Himmel
16/12/2016 06:00,263,120,143,2,6,
16/12/2016 07:00,806,534,272,2,6,Nebel
16/12/2016 08:00,773,497,276,2,7,Nebel
16/12/2016 09:00,665,462,203,2,6,
16/12/2016 10:00,600,400,200,3,9,Klarer Himmel
16/12/2016 11:00,621,355,266,4,9,Klarer Himmel
16/12/2016 12:00,782,412,370,5,7,Klarer Himmel
16/12/2016 13:00,947,445,502,6,7,Klarer Himmel
16/12/2016 14:00,1004,469,535,6,7,Klarer Himmel
16/12/2016 15:00,967,444,523,5,2,Klarer Himmel
16/12/2016 16:00,873,399,474,3,4,Klarer Himmel
16/12/2016 17:00,863,432,431,1,2,Klarer Himmel
16/12/2016 18:00,812,398,414,1,4,Klarer Himmel
16/12/2016 19:00,728,320,408,1,6,Nebel
16/12/2016 20:00,451,163,288,1,7,
16/12/2016 21:00,323,133,190,1,7,
16/12/2016 22:00,291,130,161,0,4,
16/12/2016 23:00,295,116,179,0,4,
17/12/2016 00:00,244,116,128,-1,4,Nebel
17/12/2016 01:00,191,70,121,0,6,Nebel
17/12/2016 02:00,107,51,56,0,4,
17/12/2016 03:00,108,53,55,0,6,
17/12/2016 04:00,63,28,35,1,4,
17/12/2016 05:00,57,42,15,0,2,
17/12/2016 06:00,63,39,24,0,7,
17/12/2016 07:00,116,65,51,0,6,Nebel
17/12/2016 08:00,213,122,91,1,6,Nebel
17/12/2016 09:00,396,275,121,1,6,
17/12/2016 10:00,558,383,175,2,6,
17/12/2016 11:00,644,399,245,2,6,
17/12/2016 12:00,698,394,304,3,6,
17/12/2016 13:00,718,347,371,4,2,
17/12/2016 14:00,665,322,343,4,9,
17/12/2016 15:00,643,291,352,4,2,
17/12/2016 16:00,612,288,324,4,7,wolkig
17/12/2016 17:00,610,287,323,5,4,wolkig
17/12/2016 18:00,559,239,320,5,7,Regen
17/12/2016 19:00,537,221,316,5,7,Regen
17/12/2016 20:00,382,156,226,5,6,Regen
17/12/2016 21:00,276,122,154,5,7,Regen
17/12/2016 22:00,239,126,113,5,9,wolkig
17/12/2016 23:00,226,98,128,6,9,wolkig
18/12/2016 00:00,241,109,132,6,9,Regen
18/12/2016 01:00,171,91,80,6,13,Regen
18/12/2016 02:00,101,52,49,5,9,wolkig
18/12/2016 03:00,99,55,44,6,13,wolkig
18/12/2016 04:00,63,36,27,6,13,wolkig
18/12/2016 05:00,55,42,13,6,11,wolkig
18/12/2016 06:00,43,25,18,5,9,wolkig
18/12/2016 07:00,42,21,21,5,11,wolkig
18/12/2016 08:00,55,28,27,6,15,wolkig
18/12/2016 09:00,142,83,59,6,11,wolkig
18/12/2016 10:00,226,134,92,6,11,wolkig
18/12/2016 11:00,198,114,84,7,13,wolkig
18/12/2016 12:00,293,173,120,7,11,wolkig
18/12/2016 13:00,321,179,142,7,13,wolkig
18/12/2016 14:00,334,190,144,7,9,wolkig
18/12/2016 15:00,409,215,194,7,7,wolkig
18/12/2016 16:00,409,218,191,6,13,wolkig
18/12/2016 17:00,460,255,205,6,7,wolkig
18/12/2016 18:00,367,188,179,6,6,wolkig
18/12/2016 19:00,366,173,193,6,2,wolkig
18/12/2016 20:00,308,144,164,5,6,wolkig
18/12/2016 21:00,193,105,88,5,0,wolkig
18/12/2016 22:00,163,101,62,5,0,wolkig
18/12/2016 23:00,97,59,38,5,4,wolkig
19/12/2016 00:00,43,30,13,5,4,wolkig
19/12/2016 01:00,23,13,10,5,0,wolkig
19/12/2016 02:00,10,8,2,5,0,wolkig
19/12/2016 03:00,8,6,2,5,0,wolkig
19/12/2016 04:00,22,9,13,5,0,Regen
19/12/2016 05:00,73,28,45,5,0,wolkig
19/12/2016 06:00,282,120,162,4,0,Nebel
19/12/2016 07:00,852,573,279,5,4,wolkig
19/12/2016 08:00,782,520,262,4,6,wolkig
19/12/2016 09:00,684,505,179,4,4,wolkig
19/12/2016 10:00,625,422,203,4,7,wolkig
19/12/2016 11:00,681,434,247,5,4,teilweise bewölkt
19/12/2016 12:00,757,379,378,6,7,teilweise bewölkt
19/12/2016 13:00,808,415,393,7,7,teilweise bewölkt
19/12/2016 14:00,839,444,395,6,9,teilweise bewölkt
19/12/2016 15:00,892,437,455,5,7,teilweise bewölkt
19/12/2016 16:00,1019,461,558,5,6,wolkig
19/12/2016 17:00,1163,591,572,5,9,wolkig
19/12/2016 18:00,974,453,521,4,4,teilweise bewölkt
19/12/2016 19:00,772,308,464,3,6,Klarer Himmel
19/12/2016 20:00,467,152,315,3,7,Klarer Himmel
19/12/2016 21:00,313,121,192,1,6,Klarer Himmel
19/12/2016 22:00,269,137,132,1,6,Klarer Himmel
19/12/2016 23:00,162,70,92,0,4,Klarer Himmel
20/12/2016 00:00,94,46,48,0,4,Klarer Himmel
20/12/2016 01:00,40,16,24,-1,4,Klarer Himmel
20/12/2016 02:00,24,6,18,-1,4,
20/12/2016 03:00,17,4,13,0,6,Nebel
20/12/2016 04:00,16,7,9,-1,4,Nebel
20/12/2016 05:00,80,31,49,-1,4,Nebel
20/12/2016 06:00,310,137,173,-3,0,Nebel
20/12/2016 07:00,867,582,285,-3,6,Nebel
20/12/2016 08:00,789,542,247,-3,0,Nebel
20/12/2016 09:00,707,523,184,-2,6,Nebel
20/12/2016 10:00,587,395,192,1,0,Klarer Himmel
20/12/2016 11:00,673,402,271,3,6,Klarer Himmel
20/12/2016 12:00,743,390,353,4,7,Klarer Himmel
20/12/2016 13:00,779,384,395,3,13,Klarer Himmel
20/12/2016 14:00,791,382,409,2,7,Klarer Himmel
20/12/2016 15:00,961,436,525,1,9,Klarer Himmel
20/12/2016 16:00,1072,509,563,0,6,
20/12/2016 17:00,1096,542,554,-1,4,Nebel
20/12/2016 18:00,990,434,556,-2,4,Nebel
20/12/2016 19:00,798,307,491,-2,4,Nebel
20/12/2016 20:00,478,170,308,-3,2,Nebel
20/12/2016 21:00,267,114,153,-2,6,Nebel
20/12/2016 22:00,325,162,163,-2,7,Nebel
20/12/2016 23:00,226,125,101,-2,7,
21/12/2016 00:00,122,61,61,-2,9,
21/12/2016 01:00,49,22,27,-2,6,
21/12/2016 02:00,34,15,19,-2,7,Klarer Himmel
21/12/2016 03:00,25,19,6,0,7,wolkig
21/12/2016 04:00,37,22,15,0,9,wolkig
21/12/2016 05:00,83,39,44,0,7,wolkig
21/12/2016 06:00,300,123,177,0,4,teilweise bewölkt
21/12/2016 07:00,835,573,262,0,9,Klarer Himmel
21/12/2016 08:00,782,520,262,0,9,Klarer Himmel
21/12/2016 09:00,752,532,220,1,7,Klarer Himmel
21/12/2016 10:00,719,475,244,2,9,Klarer Himmel
21/12/2016 11:00,764,445,319,4,13,Klarer Himmel
21/12/2016 12:00,821,427,394,4,15,Klarer Himmel
21/12/2016 13:00,925,466,459,6,17,Klarer Himmel
21/12/2016 14:00,882,379,503,6,13,wolkig
21/12/2016 15:00,919,448,471,5,13,wolkig
21/12/2016 16:00,999,453,546,5,13,wolkig
21/12/2016 17:00,1066,575,491,5,17,Klarer Himmel
21/12/2016 18:00,938,459,479,4,9,Klarer Himmel
21/12/2016 19:00,748,319,429,4,13,wolkig
21/12/2016 20:00,516,176,340,4,17,Regen
21/12/2016 21:00,350,141,209,4,11,Regen
21/12/2016 22:00,320,131,189,3,7,Regen
21/12/2016 23:00,196,91,105,3,6,Regen
22/12/2016 00:00,126,50,76,3,6,Regen
22/12/2016 01:00,104,53,51,3,7,Regen
22/12/2016 02:00,79,41,38,4,13,Regen
22/12/2016 03:00,32,12,20,4,11,Regen
22/12/2016 04:00,40,21,19,4,11,Regen
22/12/2016 05:00,70,33,37,3,6,Regen
22/12/2016 06:00,237,90,147,3,7,Regen
22/12/2016 07:00,567,366,201,3,7,Regen
22/12/2016 08:00,578,399,179,4,11,Regen
22/12/2016 09:00,527,356,171,4,11,Regen
22/12/2016 10:00,525,338,187,4,4,wolkig
22/12/2016 11:00,528,323,205,4,9,wolkig
22/12/2016 12:00,708,377,331,5,7,wolkig
22/12/2016 13:00,708,351,357,5,7,Regen
22/12/2016 14:00,795,420,375,6,9,Regen
22/12/2016 15:00,839,386,453,5,9,wolkig
22/12/2016 16:00,848,412,436,6,9,wolkig
22/12/2016 17:00,861,424,437,5,11,wolkig
22/12/2016 18:00,749,367,382,5,9,wolkig
22/12/2016 19:00,664,260,404,5,15,wolkig
22/12/2016 20:00,429,148,281,5,19,Regen
22/12/2016 21:00,230,92,138,5,15,Regen
22/12/2016 22:00,256,120,136,6,15,wolkig
22/12/2016 23:00,178,74,104,5,11,teilweise bewölkt
23/12/2016 00:00,114,58,56,5,11,wolkig
23/12/2016 01:00,72,36,36,4,9,teilweise bewölkt
23/12/2016 02:00,42,22,20,4,7,wolkig
23/12/2016 03:00,35,22,13,4,9,teilweise bewölkt
23/12/2016 04:00,25,8,17,5,9,wolkig
23/12/2016 05:00,59,26,33,5,11,wolkig
23/12/2016 06:00,143,78,65,5,13,wolkig
23/12/2016 07:00,320,201,119,5,13,wolkig
23/12/2016 08:00,382,249,133,5,13,wolkig
23/12/2016 09:00,419,289,130,5,15,wolkig
23/12/2016 10:00,476,314,162,6,17,wolkig
23/12/2016 11:00,570,339,231,6,15,wolkig
23/12/2016 12:00,746,394,352,7,17,wolkig
23/12/2016 13:00,786,416,370,8,15,wolkig
23/12/2016 14:00,730,331,399,8,17,wolkig
23/12/2016 15:00,763,396,367,8,15,wolkig
23/12/2016 16:00,723,332,391,7,15,Klarer Himmel
23/12/2016 17:00,666,298,368,6,17,Klarer Himmel
23/12/2016 18:00,544,232,312,6,17,Klarer Himmel
23/12/2016 19:00,433,190,243,5,20,Klarer Himmel
23/12/2016 20:00,290,114,176,5,19,Klarer Himmel
23/12/2016 21:00,141,73,68,5,22,Klarer Himmel
23/12/2016 22:00,151,78,73,4,22,wolkig
23/12/2016 23:00,165,76,89,5,26,wolkig
24/12/2016 00:00,104,37,67,6,22,wolkig
24/12/2016 01:00,134,41,93,6,26,Regen
24/12/2016 02:00,63,22,41,6,22,Regen
24/12/2016 03:00,57,27,30,6,24,Regen
24/12/2016 04:00,29,14,15,7,20,Regen
24/12/2016 05:00,21,12,9,7,22,Regen
24/12/2016 06:00,54,37,17,7,20,wolkig
24/12/2016 07:00,106,71,35,7,20,wolkig
24/12/2016 08:00,205,131,74,7,19,wolkig
24/12/2016 09:00,347,232,115,7,19,wolkig
24/12/2016 10:00,533,323,210,8,24,wolkig
24/12/2016 11:00,499,261,238,8,32,wolkig
24/12/2016 12:00,442,154,288,8,30,wolkig
24/12/2016 13:00,319,95,224,8,30,wolkig
24/12/2016 14:00,231,79,152,8,28,wolkig
24/12/2016 15:00,111,56,55,7,28,wolkig
24/12/2016 16:00,118,61,57,7,24,wolkig
24/12/2016 17:00,78,41,37,7,24,wolkig
24/12/2016 18:00,55,22,33,7,26,wolkig
24/12/2016 19:00,44,20,24,8,26,wolkig
24/12/2016 20:00,36,15,21,8,24,wolkig
24/12/2016 21:00,31,20,11,8,30,wolkig
24/12/2016 22:00,48,27,21,8,32,wolkig
24/12/2016 23:00,43,25,18,8,35,wolkig
25/12/2016 00:00,46,18,28,8,26,wolkig
25/12/2016 01:00,22,8,14,8,30,Regen
25/12/2016 02:00,10,5,5,8,26,Regen
25/12/2016 03:00,8,5,3,8,28,Regen
25/12/2016 04:00,10,8,2,8,28,Regen
25/12/2016 05:00,14,11,3,9,28,wolkig
25/12/2016 06:00,8,5,3,9,26,wolkig
25/12/2016 07:00,21,11,10,9,28,Regen
25/12/2016 08:00,24,11,13,8,28,Regen
25/12/2016 09:00,32,14,18,9,30,Regen
25/12/2016 10:00,47,22,25,9,32,Regen
25/12/2016 11:00,53,23,30,9,26,Regen
25/12/2016 12:00,64,27,37,9,22,Regen
25/12/2016 13:00,59,25,34,9,20,Regen
25/12/2016 14:00,63,37,26,9,24,Regen
25/12/2016 15:00,67,30,37,9,24,Regen
25/12/2016 16:00,47,23,24,10,24,Regen
25/12/2016 17:00,65,39,26,10,26,Regen
25/12/2016 18:00,63,42,21,10,24,Regen
25/12/2016 19:00,46,28,18,10,30,Regen
25/12/2016 20:00,46,26,20,11,26,Regen
25/12/2016 21:00,50,25,25,11,24,wolkig
25/12/2016 22:00,49,23,26,11,24,Regen
25/12/2016 23:00,38,21,17,11,26,wolkig
26/12/2016 00:00,33,15,18,11,24,Regen
26/12/2016 01:00,20,8,12,11,26,wolkig
26/12/2016 02:00,21,9,12,11,30,Regen
26/12/2016 03:00,12,4,8,11,24,Regen
26/12/2016 04:00,12,9,3,11,24,Regen
26/12/2016 05:00,17,12,5,11,26,Regen
26/12/2016 06:00,25,17,8,10,26,Regen
26/12/2016 07:00,16,8,8,10,22,Regen
26/12/2016 08:00,38,21,17,9,33,Regen
26/12/2016 09:00,37,22,15,8,24,Regen
26/12/2016 10:00,46,25,21,8,24,Regen
26/12/2016 11:00,68,35,33,8,32,wolkig
26/12/2016 12:00,87,44,43,8,32,teilweise bewölkt
26/12/2016 13:00,91,55,36,8,28,teilweise bewölkt
26/12/2016 14:00,105,56,49,8,35,teilweise bewölkt
26/12/2016 15:00,122,69,53,7,33,teilweise bewölkt
26/12/2016 16:00,138,69,69,6,26,teilweise bewölkt
26/12/2016 17:00,121,60,61,6,32,teilweise bewölkt
26/12/2016 18:00,118,58,60,6,26,teilweise bewölkt
26/12/2016 19:00,107,66,41,5,28,teilweise bewölkt
26/12/2016 20:00,94,54,40,5,28,teilweise bewölkt
26/12/2016 21:00,88,37,51,4,28,Klarer Himmel
26/12/2016 22:00,48,35,13,5,30,Klarer Himmel
26/12/2016 23:00,40,30,10,5,32,Klarer Himmel
27/12/2016 00:00,36,19,17,4,32,Klarer Himmel
27/12/2016 01:00,32,19,13,5,30,Klarer Himmel
27/12/2016 02:00,14,5,9,5,22,teilweise bewölkt
27/12/2016 03:00,19,3,16,4,20,teilweise bewölkt
27/12/2016 04:00,18,8,10,4,19,teilweise bewölkt
27/12/2016 05:00,33,21,12,4,19,wolkig
27/12/2016 06:00,131,78,53,4,19,teilweise bewölkt
27/12/2016 07:00,215,145,70,5,20,wolkig
27/12/2016 08:00,225,157,68,5,17,wolkig
27/12/2016 09:00,260,186,74,5,17,wolkig
27/12/2016 10:00,276,172,104,6,26,Klarer Himmel
27/12/2016 11:00,342,208,134,7,26,Klarer Himmel
27/12/2016 12:00,417,229,188,8,24,teilweise bewölkt
27/12/2016 13:00,408,220,188,8,22,teilweise bewölkt
27/12/2016 14:00,516,263,253,8,22,wolkig
27/12/2016 15:00,483,245,238,8,19,wolkig
27/12/2016 16:00,581,246,335,8,17,wolkig
27/12/2016 17:00,491,223,268,7,15,teilweise bewölkt
27/12/2016 18:00,372,170,202,6,15,teilweise bewölkt
27/12/2016 19:00,346,137,209,6,15,teilweise bewölkt
27/12/2016 20:00,173,67,106,5,11,teilweise bewölkt
27/12/2016 21:00,130,59,71,4,11,teilweise bewölkt
27/12/2016 22:00,146,76,70,6,9,wolkig
27/12/2016 23:00,91,56,35,6,11,wolkig
28/12/2016 00:00,55,29,26,5,11,wolkig
28/12/2016 01:00,44,29,15,5,11,wolkig
28/12/2016 02:00,26,16,10,3,11,wolkig
28/12/2016 03:00,15,5,10,2,13,teilweise bewölkt
28/12/2016 04:00,14,6,8,2,7,Klarer Himmel
28/12/2016 05:00,41,25,16,2,6,
28/12/2016 06:00,141,75,66,0,0,Nebel
28/12/2016 07:00,247,161,86,3,11,Nebel
28/12/2016 08:00,292,196,96,3,9,Nebel
28/12/2016 09:00,346,252,94,3,9,Nebel
28/12/2016 10:00,334,230,104,3,9,wolkig
28/12/2016 11:00,420,265,155,4,6,wolkig
28/12/2016 12:00,535,290,245,4,7,wolkig
28/12/2016 13:00,501,264,237,5,7,wolkig
28/12/2016 14:00,473,226,247,5,6,wolkig
28/12/2016 15:00,583,267,316,5,7,wolkig
28/12/2016 16:00,587,258,329,4,4,wolkig
28/12/2016 17:00,536,245,291,4,6,wolkig
28/12/2016 18:00,429,195,234,4,6,wolkig
28/12/2016 19:00,332,141,191,4,2,wolkig
28/12/2016 20:00,215,81,134,4,0,wolkig
28/12/2016 21:00,161,70,91,5,4,wolkig
28/12/2016 22:00,146,68,78,4,4,wolkig
28/12/2016 23:00,113,59,54,3,4,wolkig
29/12/2016 00:00,76,40,36,3,4,wolkig
29/12/2016 01:00,63,28,35,0,2,teilweise bewölkt
29/12/2016 02:00,44,24,20,-1,0,Nebel
29/12/2016 03:00,21,12,9,-2,0,Nebel
29/12/2016 04:00,22,12,10,-3,0,Nebel
29/12/2016 05:00,53,30,23,-3,0,Nebel
29/12/2016 06:00,134,77,57,-3,0,Nebel
29/12/2016 07:00,235,149,86,-3,0,Nebel
29/12/2016 08:00,288,199,89,-4,2,Nebel
29/12/2016 09:00,297,201,96,-1,6,Klarer Himmel
29/12/2016 10:00,332,215,117,1,4,Klarer Himmel
29/12/2016 11:00,406,251,155,3,7,Klarer Himmel
29/12/2016 12:00,443,257,186,4,4,Klarer Himmel
29/12/2016 13:00,488,245,243,5,7,Klarer Himmel
29/12/2016 14:00,546,283,263,5,9,Klarer Himmel
29/12/2016 15:00,567,261,306,4,7,Klarer Himmel
29/12/2016 16:00,583,267,316,2,4,Klarer Himmel
29/12/2016 17:00,560,257,303,0,4,Klarer Himmel
29/12/2016 18:00,478,195,283,1,7,Klarer Himmel
29/12/2016 19:00,400,165,235,0,6,Klarer Himmel
29/12/2016 20:00,234,93,141,-2,2,Klarer Himmel
29/12/2016 21:00,140,73,67,-3,6,Nebel
29/12/2016 22:00,141,56,85,-3,4,Nebel
29/12/2016 23:00,117,64,53,-3,0,Nebel
30/12/2016 00:00,technische Störung,,,,,
30/12/2016 01:00,technische Störung,,,,,
30/12/2016 02:00,technische Störung,,,,,
30/12/2016 03:00,technische Störung,,,,,
30/12/2016 04:00,technische Störung,,,,,
30/12/2016 05:00,technische Störung,,,,,
30/12/2016 06:00,technische Störung,,,,,
30/12/2016 07:00,technische Störung,,,,,
30/12/2016 08:00,technische Störung,,,,,
30/12/2016 09:00,technische Störung,,,,,
30/12/2016 10:00,technische Störung,,,,,
30/12/2016 11:00,technische Störung,,,,,
30/12/2016 12:00,technische Störung,,,,,
30/12/2016 13:00,technische Störung,,,,,
30/12/2016 14:00,technische Störung,,,,,
30/12/2016 15:00,technische Störung,,,,,
30/12/2016 16:00,technische Störung,,,,,
30/12/2016 17:00,technische Störung,,,,,
30/12/2016 18:00,technische Störung,,,,,
30/12/2016 19:00,technische Störung,,,,,
30/12/2016 20:00,technische Störung,,,,,
30/12/2016 21:00,technische Störung,,,,,
30/12/2016 22:00,technische Störung,,,,,
30/12/2016 23:00,technische Störung,,,,,
31/12/2016 00:00,technische Störung,,,,,
31/12/2016 01:00,technische Störung,,,,,
31/12/2016 02:00,technische Störung,,,,,
31/12/2016 03:00,technische Störung,,,,,
31/12/2016 04:00,technische Störung,,,,,
31/12/2016 05:00,technische Störung,,,,,
31/12/2016 06:00,technische Störung,,,,,
31/12/2016 07:00,technische Störung,,,,,
31/12/2016 08:00,technische Störung,,,,,
31/12/2016 09:00,technische Störung,,,,,
31/12/2016 10:00,technische Störung,,,,,
31/12/2016 11:00,technische Störung,,,,,
31/12/2016 12:00,technische Störung,,,,,
31/12/2016 13:00,technische Störung,,,,,
31/12/2016 14:00,technische Störung,,,,,
31/12/2016 15:00,technische Störung,,,,,
31/12/2016 16:00,technische Störung,,,,,
31/12/2016 17:00,technische Störung,,,,,
31/12/2016 18:00,technische Störung,,,,,
31/12/2016 19:00,technische Störung,,,,,
31/12/2016 20:00,technische Störung,,,,,
31/12/2016 21:00,technische Störung,,,,,
31/12/2016 22:00,technische Störung,,,,,
31/12/2016 23:00,technische Störung,,,,,
,,,,,,
Jahressumme,3589382,,,,,
